BioProject,name,taxonomy_id,taxonomy_lvl,kraken_assigned_reads,added_reads,new_est_reads,fraction_total_reads
PRJNA1077663,Pseudomonas sp. S150,2559074,S,8568,2886509,2895077,0.54325
PRJNA886972,Achromobacter xylosoxidans,85698,S,607401,38616,646017,0.51374
PRJNA1048377,Staphylococcus aureus,1280,S,233749,1434559,1668308,0.44799
PRJNA646315,Saccharomyces cerevisiae,4932,S,8358196,64138,8422334,0.44598
PRJNA819236,Pseudomonas sp. B14-6,2738843,S,404191,945052,1349243,0.3563
PRJNA818470,Actinomyces oris,544580,S,4989060,133469,5122529,0.29397
PRJNA1044261,Pseudomonas sp. S150,2559074,S,3936,412578,416514,0.28525
PRJNA1044261,Pseudomonas aeruginosa,287,S,67865,261933,329798,0.2833
PRJEB21503,Staphylococcus epidermidis,1282,S,4745011,299245,5044256,0.26167
PRJNA381365,Kocuria sp. BT304,1702043,S,981017,1573362,2554379,0.23541
PRJNA847046,Paracoccus yeei,147645,S,12480,1421497,1433977,0.23104
PRJNA564695,Corynebacterium glutamicum,1718,S,1970,310950,312920,0.22804
PRJNA692666,Corynebacterium glutamicum,1718,S,2038,300663,302701,0.21228
PRJNA381365,Kocuria rhizophila,72000,S,1281587,978915,2260502,0.2082
PRJDB10068,Rhodanobacter glycinis,582702,S,155454,5232,160686,0.20613
PRJNA693337,Paucibacter sp. S2-9,3019553,S,536031,27297,563328,0.17776
PRJNA610482,Staphylococcus epidermidis,1282,S,75590704,9087419,84678123,0.17626
PRJEB55147,Cutibacterium acnes,1747,S,32631132,523562,33154694,0.16642
PRJNA689968,Bifidobacterium longum,216816,S,70237,324851,395088,0.16172
PRJNA910807,Cutibacterium acnes,1747,S,103154,1993,105147,0.16071
PRJNA912096,Staphylococcus aureus,1280,S,11755,322888,334643,0.15934
PRJNA819236,Pseudomonas sp. S150,2559074,S,4330,573867,578197,0.15303
PRJNA642342,Bifidobacterium longum,216816,S,51924,245324,297248,0.15007
PRJNA1048173,Anoxybacillus flavithermus,33934,S,5469840,187243,5657083,0.14859
PRJEB55147,Staphylococcus epidermidis,1282,S,30513433,1316426,31829859,0.14664
PRJNA912212,Cutibacterium acnes,1747,S,228525,3114,231639,0.14367
PRJNA749068,Pedobacter mucosus,2895286,S,999719,82079,1081798,0.14066
PRJNA894103,Blautia wexlerae,418240,S,348270,45740,394010,0.13382
PRJNA818470,Malassezia restricta,76775,S,2991971,2100,2994071,0.13011
PRJNA1048173,Lysobacter solisilvae,2763317,S,4605507,243892,4849399,0.12798
PRJNA692666,Pseudomonas sp. S150,2559074,S,5907,262430,268337,0.12772
PRJDB15234,Muribaculum intestinale,1796646,S,151425,16838,168263,0.12741
PRJEB21503,Cutibacterium acnes,1747,S,3674,333,4007,0.12703
PRJNA328002,Toxoplasma gondii,5811,S,2400,6,2406,0.125
PRJNA328002,Cryptococcus neoformans,5207,S,4233,10,4243,0.12424
PRJNA818470,Enterobacter sp. T2,2707174,S,3451271,617123,4068394,0.12081
PRJNA1048173,Pseudomonas sp. S150,2559074,S,6235,4328402,4334637,0.11988
PRJEB21503,Enterococcus faecalis,1351,S,2729078,976888,3705966,0.11747
PRJNA564695,Staphylococcus aureus,1280,S,34948,115424,150372,0.11481
PRJNA1048173,Pseudomonas aeruginosa,287,S,119199,3858785,3977984,0.10799
PRJNA745199,Burkholderia ubonensis,101571,S,1261314,488371,1749685,0.10732
PRJNA1036535,Streptococcus pneumoniae,1313,S,1380754,16613,1397367,0.10604
PRJNA910807,Staphylococcus aureus,1280,S,17779,43744,61523,0.10506
PRJDB10068,Delftia tsuruhatensis,180282,S,869,78528,79397,0.10119
PRJNA818470,Aspergillus steynii,306088,S,4589983,3373,4593356,0.09601
PRJNA818470,Bacillus cereus,1396,S,931705,1433935,2365640,0.09571
PRJNA642342,Cutibacterium acnes,1747,S,177036,19627,196663,0.09534
PRJNA415338,Pseudomonas chlororaphis,587753,S,1302,240901,242203,0.09496
PRJNA429692,Escherichia coli,562,S,8906543,110347993,119254536,0.09444
PRJNA802336,Enterococcus faecium,1352,S,79242174,46514439,125756613,0.094
PRJNA879945,Simonsiella muelleri,72,S,80103,768,80871,0.09225
PRJNA629667,Staphylococcus aureus,1280,S,274338,526592,800930,0.09161
PRJNA886972,Achromobacter pestifer,1353889,S,103996,6081,110077,0.08814
PRJNA847046,Streptococcus agalactiae,1311,S,24995,560512,585507,0.08774
PRJNA1048173,Cupriavidus cauae,2608999,S,9445,3297700,3307145,0.08751
PRJNA328002,Simplexvirus humanalpha1,3050292,S,210,0,210,0.08495
PRJNA721101,Corynebacterium glutamicum,1718,S,221,145764,145985,0.08364
PRJNA937315,Streptococcus pneumoniae,1313,S,46861,8109,54970,0.08324
PRJDB15234,Rhodopseudomonas boonkerdii,475937,S,33040,33051,66091,0.08254
PRJNA912096,Cutibacterium acnes,1747,S,276,23,299,0.08241
PRJNA486134,Pseudomonas yamanorum,515393,S,91834,60086,151920,0.08174
PRJNA721101,Streptomyces sp. CB00271,2750025,S,133456,1990,135446,0.07947
PRJNA912212,Ralstonia sp. RS647,2880989,S,970,208978,209948,0.07833
PRJNA689968,Cutibacterium acnes,1747,S,177036,19627,196663,0.07801
PRJDB10133,Pseudomonas sp. S150,2559074,S,863,155876,156739,0.07537
PRJNA328002,Brucella anthropi,529,S,49,831,880,0.07481
PRJNA398289,Escherichia coli,562,S,4477473,57726116,62203589,0.07359
PRJNA328002,Pseudomonas citronellolis,53408,S,20,7,27,0.07337
PRJNA912096,Streptococcus agalactiae,1311,S,415,145699,146114,0.07331
PRJNA819236,Ralstonia sp. RS650,2880990,S,1068,280319,281387,0.07326
PRJNA564695,Cutibacterium acnes,1747,S,82335,283,82618,0.0707
PRJNA693337,Kamchatkavirus AP45,2843645,S,321047,5991,327038,0.0701
PRJNA486134,Avian leukosis virus,11864,S,97619,40781,138400,0.06963
PRJNA807746,Lactiplantibacillus plantarum,1590,S,11381,442310,453691,0.06931
PRJNA415338,Sphingomonas koreensis,93064,S,25672,147605,173277,0.06794
PRJNA629667,Corynebacterium glutamicum,1718,S,11422,595537,606959,0.06765
PRJDB10068,Bifidobacterium breve,1685,S,48155,4245,52400,0.06686
PRJNA642342,Candidatus Koribacter versatilis,658062,S,117117,28587,145704,0.0668
PRJDB15234,Sodaliphilus pleomorphus,2606626,S,88496,1440,89936,0.06506
PRJNA879945,Akkermansia muciniphila,239935,S,63320,299,63619,0.06279
PRJNA689968,Candidatus Koribacter versatilis,658062,S,130156,33036,163192,0.06216
PRJNA749068,Moraxella osloensis,34062,S,499672,1561,501233,0.06175
PRJNA720296,Catenovulum sp. TS8,2984846,S,285260,37459,322719,0.06118
PRJNA693337,Blautia wexlerae,418240,S,141753,57089,198842,0.06018
PRJNA937315,Sphingomonas sp. FARSPH,2219696,S,506803,18735,525538,0.05888
PRJNA398289,Cutibacterium acnes,1747,S,28289005,739577,29028582,0.05872
PRJNA807746,Cutibacterium acnes,1747,S,170290,444,170734,0.05863
PRJNA629667,Moraxella osloensis,34062,S,506381,1205,507586,0.05862
PRJNA912212,Flavobacterium sp. M31R6,2739062,S,201981,14312,216293,0.05801
PRJNA879945,Corynebacterium glutamicum,1718,S,189,105591,105780,0.05794
PRJDB15234,Duncaniella sp. B8,2576606,S,63442,7634,71076,0.05757
PRJNA745199,Cutibacterium acnes,1747,S,190698,5616,196314,0.05754
PRJNA629667,Simonsiella muelleri,72,S,465641,38326,503967,0.05695
PRJNA819236,Pseudomonas aeruginosa,287,S,35878,175845,211723,0.05631
PRJNA429692,Cutibacterium acnes,1747,S,28404172,743395,29147567,0.05623
PRJNA692666,Staphylococcus aureus,1280,S,15496,66077,81573,0.05534
PRJNA328002,Acidovorax temperans,80878,S,51,0,51,0.05496
PRJNA721101,Staphylococcus aureus,1280,S,2706,78801,81507,0.05476
PRJNA689968,Faecalibacterium prausnitzii,853,S,24920,128518,153438,0.05363
PRJNA642342,Faecalibacterium prausnitzii,853,S,19917,106984,126901,0.05363
PRJNA1044261,Pseudomonas putida,303,S,9918,33300,43218,0.05347
PRJNA807746,Staphylococcus aureus,1280,S,8704,176422,185126,0.05327
PRJNA1048377,Acinetobacter sp. AOR07_HL,2919376,S,1494,29486,30980,0.05296
PRJNA1048173,Cupriavidus oxalaticus,96344,S,7906,1974754,1982660,0.05268
PRJDB10133,Stenotrophomonas maltophilia,40324,S,3551,133446,136997,0.05248
PRJNA1044261,Pseudomonas sp. JS425,2829498,S,1389,43901,45290,0.05193
PRJNA328002,Sphingomonas sp. NIBR02145,3014784,S,1471,5636,7107,0.0505
PRJNA910807,Corynebacterium kroppenstedtii,161879,S,25882,6094,31976,0.05047
PRJNA847046,Escherichia coli,562,S,16303,125758,142061,0.04892
PRJNA1010661,Listeria monocytogenes,1639,S,6975,486,7461,0.04892
PRJNA328002,Delftia acidovorans,80866,S,16,2,18,0.04891
PRJDB10133,Achromobacter spanius,217203,S,782,136417,137199,0.04851
PRJNA749068,Caldalkalibacillus thermarum,296745,S,188902,34713,223615,0.0465
PRJNA629667,Methylobacterium radiotolerans,31998,S,364403,19024,383427,0.04571
PRJNA912096,Segatella copri,165179,S,7157,5,7162,0.04554
PRJNA910807,Simonsiella muelleri,72,S,95020,2874,97894,0.04549
PRJNA721101,Simonsiella muelleri,72,S,65809,339,66148,0.04487
PRJNA802336,Cutibacterium acnes,1747,S,533156,16502,549658,0.04451
PRJNA381365,Cellulosimicrobium cellulans,1710,S,251610,358350,609960,0.04444
PRJNA879945,Cutibacterium acnes,1747,S,16941,82,17023,0.04399
PRJNA693337,Faecalibacterium prausnitzii,853,S,15053,128499,143552,0.0435
PRJNA720296,Phenylobacterium parvum,2201350,S,229543,7571,237114,0.04315
PRJNA610482,Staphylococcus aureus,1280,S,5944235,10763202,16707437,0.04199
PRJNA912212,Staphylococcus aureus,1280,S,19320,46324,65644,0.04125
PRJNA610482,Weissella cibaria,137591,S,9236151,214844,9450995,0.04117
PRJDB10068,Sphingomonas paucimobilis,13689,S,414,30613,31027,0.03964
PRJNA912212,Ralstonia sp. RS650,2880990,S,1005,111777,112782,0.03939
PRJNA802336,Bifidobacterium animalis,28025,S,51428424,971093,52399517,0.03917
PRJNA564695,Simonsiella muelleri,72,S,49925,2942,52867,0.03866
PRJNA1048377,Pseudomonas aeruginosa,287,S,20726,171959,192685,0.03853
PRJNA328002,Sphingomonas sp. FARSPH,2219696,S,224,4372,4596,0.03839
PRJNA328002,Brucella abortus,235,S,25,10106,10131,0.03786
PRJNA1077663,Pseudomonas aeruginosa,287,S,16618,181825,198443,0.03729
PRJDB15234,Delftia tsuruhatensis,180282,S,379,57853,58232,0.03706
PRJNA847046,Haemophilus influenzae,727,S,75226,133024,208250,0.03683
PRJNA721101,Sphingobium chlorophenolicum,46429,S,225,80033,80258,0.03654
PRJNA818470,Candida albicans,5476,S,1975878,26,1975904,0.0362
PRJNA818470,Aspergillus flavus,5059,S,1531656,10211,1541867,0.03554
PRJNA1048173,Corynebacterium diphtheriae,1717,S,7567,1355744,1363311,0.03469
PRJNA381365,Burkholderia arboris,488730,S,148342,47473,195815,0.03443
PRJNA910807,Corynebacterium glutamicum,1718,S,269,82842,83111,0.03402
PRJNA629667,Sphingomonas sp. NBWT7,2596913,S,10009,275238,285247,0.03397
PRJNA1048173,Corynebacterium sp. ATCC 6931,1487956,S,19509,1317066,1336575,0.03365
PRJNA802336,Rothia mucilaginosa,43675,S,38908416,356218,39264634,0.03293
PRJNA721101,Moraxella osloensis,34062,S,47192,144,47336,0.03198
PRJNA807746,Corynebacterium glutamicum,1718,S,391,130896,131287,0.03153
PRJNA847046,Streptococcus thermophilus,1308,S,84293,144201,228494,0.03097
PRJDB10133,Pseudomonas aeruginosa,287,S,7406,50170,57576,0.03074
PRJEB21503,Bradyrhizobium sp. SK17,2057741,S,2278,412,2690,0.03058
PRJDB15234,Barnesiella viscericola,397865,S,35467,1925,37392,0.03056
PRJNA720296,Catenovulum sediminis,1740262,S,146799,15730,162529,0.03055
PRJNA879945,Moraxella osloensis,34062,S,23683,60,23743,0.03051
PRJNA328002,Vesiculovirus indiana,1972577,S,75,0,75,0.03034
PRJNA1048377,Moraxella bovoculi,386891,S,14416,13880,28296,0.03003
PRJDB10133,Methylobacterium nodulans,114616,S,2201,86366,88567,0.02997
PRJNA486134,Sphingomonas melonis,152682,S,34347,19469,53816,0.02972
PRJNA328002,Rubivirus rubellae,2846071,S,290,0,290,0.02912
PRJNA912096,Streptococcus pneumoniae,1313,S,588,45511,46099,0.02906
PRJNA847046,Rothia mucilaginosa,43675,S,177660,23617,201277,0.02883
PRJNA381365,Mycobacteroides chelonae,1774,S,73832,2606,76438,0.02863
PRJNA807746,Pseudomonas aeruginosa,287,S,2861,103191,106052,0.02858
PRJNA912212,Ralstonia solanacearum,305,S,4262,74384,78646,0.02855
PRJEB21503,Staphylococcus hominis,1290,S,1111,88,1199,0.02844
PRJNA912096,Pseudomonas aeruginosa,287,S,1662,60415,62077,0.02844
PRJNA610482,Staphylococcus warneri,1292,S,7598615,5579160,13177775,0.02842
PRJNA749068,Anoxybacillus flavithermus,33934,S,285290,67502,352792,0.02841
PRJNA328002,Sordaria macrospora,5147,S,25,0,25,0.02694
PRJNA879945,Streptomyces sp. CB00271,2750025,S,61030,810,61840,0.02687
PRJNA912096,Muribaculum intestinale,1796646,S,232,4,236,0.02649
PRJNA879945,Staphylococcus aureus,1280,S,888,23652,24540,0.02638
PRJNA381365,Staphylococcus aureus,1280,S,463588,1422721,1886309,0.02635
PRJNA749068,Enterococcus faecium,1352,S,16186,292690,308876,0.02601
PRJNA912096,Methylobacterium sp. FF17,2984843,S,170,0,170,0.02591
PRJNA692666,Simonsiella muelleri,72,S,34612,3281,37893,0.02591
PRJNA692666,Corynebacterium sp. ATCC 6931,1487956,S,345,43339,43684,0.02557
PRJNA1010661,Corynebacterium macginleyi,38290,S,4073,153,4226,0.02538
PRJNA894103,Faecalibacterium prausnitzii,853,S,6790,72296,79086,0.02533
PRJNA912096,Bacteroides fragilis,817,S,98,30,128,0.02501
PRJNA819236,Muribaculum intestinale,1796646,S,99532,1646,101178,0.02464
PRJNA486134,Ralstonia pickettii,329,S,36354,3941,40295,0.02458
PRJDB15234,Limosilactobacillus reuteri,1598,S,9718,29145,38863,0.02449
PRJDB10133,Sphingomonas nostoxanthinifaciens,2872652,S,28240,30287,58527,0.02444
PRJEB21503,Pseudomonas fluorescens,294,S,2098,1866,3964,0.02429
PRJNA692666,Cutibacterium acnes,1747,S,23468,125,23593,0.02428
PRJNA894103,Acetobacter aceti,435,S,39887,28743,68630,0.02423
PRJEB21503,Staphylococcus aureus,1280,S,1447,1178,2625,0.02403
PRJNA749068,Desulfovibrio piger,901,S,92,5,97,0.02398
PRJEB21503,Serratia marcescens,615,S,231,148,379,0.02378
PRJDB10133,Staphylococcus aureus,1280,S,8297,23025,31322,0.02311
PRJNA912096,Brevundimonas pondensis,2774189,S,20328,30629,50957,0.02311
PRJNA328002,Verticillium dahliae,27337,S,229,0,229,0.02299
PRJNA564695,Sphingomonas cannabina,2899123,S,5795,20303,26098,0.02295
PRJNA818470,Aspergillus fumigatus,746128,S,1330702,9684,1340386,0.02276
PRJEB21503,Janthinobacterium svalbardensis,368607,S,3045,826,3871,0.02271
PRJNA328002,Staphylococcus xylosus,1288,S,21,0,21,0.02263
PRJNA721101,Chryseobacterium sp. 6424,2039166,S,19260,15454,34714,0.0226
PRJNA564695,Corynebacterium sp. ATCC 6931,1487956,S,336,35683,36019,0.02242
PRJNA629667,Sphingomonas nostoxanthinifaciens,2872652,S,2822,186788,189610,0.02219
PRJEB21503,Bradyrhizobium sp. CCBAU 53421,1325120,S,1537,351,1888,0.02215
PRJNA879945,Duncaniella sp. B8,2576606,S,22214,315,22529,0.02197
PRJDB10133,Acinetobacter ursingii,108980,S,36826,360,37186,0.02173
PRJNA879945,Pseudomonas aeruginosa,287,S,598,27819,28417,0.0217
PRJNA381365,Simplexvirus humanalpha1,3050292,S,972599,351,972950,0.0217
PRJEB55147,Corynebacterium bovis,36808,S,1582664,6207,1588871,0.02166
PRJNA564695,Corynebacterium diphtheriae,1717,S,266,40540,40806,0.02123
PRJNA721101,Acinetobacter baumannii,470,S,963,33134,34097,0.02121
PRJNA912096,Kroppenstedtia eburnea,714067,S,63,9,72,0.02104
PRJNA695410,Muribaculum intestinale,1796646,S,59006,2605,61611,0.02101
PRJNA1048377,Corynebacterium glutamicum,1718,S,154,31201,31355,0.02081
PRJNA328002,Allomyces macrogynus,28583,S,19,0,19,0.02047
PRJNA802336,Enterocloster bolteae,208479,S,24814273,459662,25273935,0.02042
PRJNA910807,Corynebacterium sp. ATCC 6931,1487956,S,113,45488,45601,0.0203
PRJNA912096,Enterococcus faecium,1352,S,301,19552,19853,0.0202
PRJEB21503,Salmonella enterica,28901,S,147,2788,2935,0.02011
PRJNA807746,Simonsiella muelleri,72,S,61074,1164,62238,0.01997
PRJNA910807,Corynebacterium kutscheri,35755,S,3856,1704,5560,0.01986
PRJNA802336,Actinomyces sp. oral taxon 414,712122,S,36354313,686387,37040700,0.0198
PRJEB21503,Acinetobacter sp. MYb10,1827285,S,2136,1149,3285,0.01977
PRJNA912096,Prevotella dentalis,52227,S,157,72,229,0.01962
PRJNA802336,Escherichia coli,562,S,562,11885,12447,0.01958
PRJEB55147,Corynebacterium accolens,38284,S,3946088,732690,4678778,0.01953
PRJDB10068,Pseudomonas sp. S150,2559074,S,221,15068,15289,0.01952
PRJNA629667,Acinetobacter sp. AOR07_HL,2919376,S,1976,174373,176349,0.01946
PRJNA802336,Neisseria subflava,28449,S,14613752,5131713,19745465,0.0194
PRJNA910807,Corynebacterium bovis,36808,S,6834,677,7511,0.01938
PRJNA894103,Bifidobacterium adolescentis,1680,S,43011,6034,49045,0.01935
PRJNA744578,Acinetobacter sp. AOR07_HL,2919376,S,638,226912,227550,0.0193
PRJNA629667,Corynebacterium sp. ATCC 6931,1487956,S,3670,164879,168549,0.01899
PRJNA486134,Rous sarcoma virus,11886,S,4840,8650,13490,0.0189
PRJNA937315,Staphylococcus epidermidis,1282,S,16312,1240,17552,0.0189
PRJNA910807,Corynebacterium ulcerans,65058,S,141,3506,3647,0.0188
PRJDB10133,Acinetobacter sp. AOR07_HL,2919376,S,508,42042,42550,0.01877
PRJNA894103,Corynebacterium glutamicum,1718,S,350,80284,80634,0.01843
PRJNA894103,Phocaeicola vulgatus,821,S,55767,730,56497,0.01837
PRJNA398289,Acinetobacter junii,40215,S,10143962,1054439,11198401,0.01814
PRJNA802336,Blautia hansenii,1322,S,19331588,1233874,20565462,0.01807
PRJDB10133,Pandoraea sputorum,93222,S,693,42541,43234,0.01794
PRJNA802336,Prevotella intermedia,28131,S,1456708,206914,1663622,0.01793
PRJNA721101,Streptococcus equi,1336,S,34994,201,35195,0.01791
PRJNA1077663,Ralstonia sp. RS650,2880990,S,432,139438,139870,0.01773
PRJNA912212,Corynebacterium aquatimens,1190508,S,4588,23427,28015,0.01771
PRJNA802336,Streptococcus pneumoniae,1313,S,16787,881,17668,0.0174
PRJDB15234,Lactobacillus taiwanensis,508451,S,19761,27262,47023,0.01724
PRJNA429692,Acinetobacter junii,40215,S,10143958,1054440,11198398,0.01718
PRJNA1077663,Cutibacterium acnes,1747,S,92779,687,93466,0.01696
PRJNA807746,Corynebacterium sanguinis,2594913,S,4222,35563,39785,0.01692
PRJDB10133,Yersinia pestis,632,S,6210,43138,49348,0.01679
PRJDB15234,Cutibacterium acnes,1747,S,16803,69,16872,0.01678
PRJNA749068,Escherichia coli,562,S,106498,74268,180766,0.01666
PRJNA486134,Pseudomonas sp. G11,528343,S,1483,30523,32006,0.01651
PRJNA692666,Pseudomonas aeruginosa,287,S,9973,20845,30818,0.01629
PRJNA912096,Moraxella ovis,29433,S,22,33278,33300,0.01624
PRJNA745199,Burkholderia cenocepacia,95486,S,104572,216575,321147,0.01609
PRJNA912212,Ponticoccus alexandrii,1943633,S,52757,3978,56735,0.01603
PRJEB21503,Janthinobacterium tructae,2590869,S,1949,543,2492,0.01584
PRJNA398289,Staphylococcus epidermidis,1282,S,968961,86609,1055570,0.01581
PRJNA910807,Corynebacterium accolens,38284,S,151,10636,10787,0.01571
PRJDB10133,Sphingomonas paucimobilis,13689,S,332,23262,23594,0.0157
PRJNA1010661,Acinetobacter nosocomialis,106654,S,1571,304,1875,0.01562
PRJNA818470,Pseudomonas sp. CIP-10,2892442,S,185221,67094,252315,0.01549
PRJNA610482,Alphatorquevirus homin19,3048420,S,225294,9652,234946,0.0154
PRJNA802336,Bifidobacterium bifidum,1681,S,5916126,11946421,17862547,0.01536
PRJNA912096,Streptomyces sp. CB00271,2750025,S,32,13,45,0.01521
PRJEB21503,Escherichia coli,562,S,1050,3374,4424,0.01519
PRJDB10068,Delftia lacustris,558537,S,83,11717,11800,0.01504
PRJNA398289,Haemophilus influenzae,727,S,374556,53162,427718,0.01498
PRJNA429692,Staphylococcus epidermidis,1282,S,968961,86609,1055570,0.01497
PRJNA328002,Mycolicibacterium aubagnense,319707,S,71,78,149,0.01496
PRJNA879945,Muribaculum intestinale,1796646,S,15315,267,15582,0.0149
PRJNA807746,Yersinia pestis,632,S,821,96077,96898,0.01482
PRJNA894103,Streptomyces mobaraensis,35621,S,353,45333,45686,0.01479
PRJNA847046,Streptococcus pneumoniae,1313,S,14714,76106,90820,0.01476
PRJNA692666,Moraxella ovis,29433,S,197,29258,29455,0.01464
PRJNA847046,Klebsiella pneumoniae,573,S,4952,2641,7593,0.01455
PRJEB21503,Paenibacillus marchantiae,3026433,S,179,19,198,0.01452
PRJNA912096,Flintibacter sp. KGMB00164,2610895,S,22,11,33,0.01449
PRJNA486134,Escherichia coli,562,S,116,14829,14945,0.01431
PRJNA879945,Castellaniella defragrans,75697,S,20385,210,20595,0.01421
PRJNA720296,Faecalibacterium prausnitzii,853,S,24237,52369,76606,0.01419
PRJNA429692,Haemophilus influenzae,727,S,374556,53162,427718,0.01419
PRJNA328002,Prevotella melaninogenica,28132,S,170,12,182,0.01409
PRJNA749068,Parageobacillus caldoxylosilyticus,81408,S,137617,8125,145742,0.0137
PRJNA819236,Akkermansia muciniphila,239935,S,53138,3256,56394,0.01367
PRJNA818470,Janthinobacterium agaricidamnosum,55508,S,209561,357,209918,0.01366
PRJEB21503,Bradyrhizobium quebecense,2748629,S,789,264,1053,0.01363
PRJDB10068,Streptococcus thermophilus,1308,S,3378,7210,10588,0.01359
PRJNA937315,Ralstonia pickettii,329,S,142422,4182,146604,0.01354
PRJNA894103,Simonsiella muelleri,72,S,46126,510,46636,0.01349
PRJNA912096,Brevefilum fermentans,1986204,S,53,0,53,0.0134
PRJDB15234,Staphylococcus aureus,1280,S,8039,20602,28641,0.01338
PRJNA629667,Chryseobacterium sp. 6424,2039166,S,82140,34954,117094,0.0133
PRJNA381365,Candida albicans,5476,S,46384,12,46396,0.01315
PRJNA912096,Moraxella osloensis,34062,S,59,1,60,0.01312
PRJNA802336,Neisseria perflava,33053,S,101295,25876242,25977537,0.01309
PRJNA912096,Blautia wexlerae,418240,S,188,559,747,0.01298
PRJNA629667,Finegoldia magna,1260,S,112293,260,112553,0.01292
PRJDB10068,Streptococcus agalactiae,1311,S,364,9758,10122,0.01287
PRJNA744578,Streptococcus agalactiae,1311,S,1093,158669,159762,0.0127
PRJNA802336,Blautia producta,33035,S,15671087,272885,15943972,0.0127
PRJDB15234,Sphingomonas nostoxanthinifaciens,2872652,S,230,18004,18234,0.01268
PRJNA937315,Pandoraea norimbergensis,93219,S,114998,3804,118802,0.01262
PRJDB10068,Staphylococcus aureus,1280,S,4363,5120,9483,0.01251
PRJNA564695,Moraxella osloensis,34062,S,10913,18,10931,0.01245
PRJNA807746,Ligilactobacillus salivarius,1624,S,54267,1294,55561,0.01232
PRJDB10133,Kocuria sp. KD4,2719588,S,144,38322,38466,0.01225
PRJNA610482,Weissella confusa,1583,S,2004039,40993,2045032,0.01218
PRJNA693337,Candidatus Profftella armatura,669502,S,49272,329,49601,0.01207
PRJNA894103,Bifidobacterium longum,216816,S,9121,25773,34894,0.012
PRJNA912096,Lentibacillus daqui,2911514,S,67,3,70,0.01176
PRJDB10133,Comamonas sp. PR12,2977320,S,69,33366,33435,0.01167
PRJNA912212,Bacillus cereus,1396,S,12261,27468,39729,0.01156
PRJNA328002,Bacillus thuringiensis,1428,S,16,133,149,0.01153
PRJEB21503,Bradyrhizobium sp. 41S5,1404443,S,511,280,791,0.01141
PRJDB15234,Ligilactobacillus salivarius,1624,S,316,25376,25692,0.01137
PRJNA1048377,Anabaena sp. YBS01,2490939,S,3248,3922,7170,0.01134
PRJNA486134,Y73 sarcoma virus,11884,S,16205,42870,59075,0.0112
PRJNA486134,Streptococcus parasanguinis,1318,S,8559,2592,11151,0.01114
PRJNA749068,Ralstonia mannitolilytica,105219,S,121552,17424,138976,0.01108
PRJNA564695,Haemophilus influenzae,727,S,13931,3870,17801,0.01107
PRJNA721101,Corynebacterium sp. ATCC 6931,1487956,S,82,23103,23185,0.01102
PRJNA894103,Segatella copri,165179,S,35406,9,35415,0.01098
PRJNA1077663,Methanothrix soehngenii,2223,S,25786,7,25793,0.01089
PRJDB10068,Rhodococcus erythropolis,1833,S,580,8006,8586,0.01086
PRJNA749068,Bosea sp. NBC_00550,2969621,S,72362,10286,82648,0.01075
PRJNA802336,Ruminococcus gnavus,33038,S,11912969,667204,12580173,0.01074
PRJNA695410,Duncaniella sp. B8,2576606,S,28288,1332,29620,0.01073
PRJNA1044261,Comamonas sp. 7D-2evo1,2927787,S,136,55100,55236,0.01071
PRJNA912212,Staphylococcus capitis,29388,S,20922,202,21124,0.01068
PRJDB10133,Cutibacterium acnes,1747,S,13547,259,13806,0.01067
PRJNA695410,Segatella copri,165179,S,24357,177,24534,0.01064
PRJNA1077663,Corynebacterium glutamicum,1718,S,173,47168,47341,0.01051
PRJNA695410,Faecalibaculum rodentium,1702221,S,25477,264,25741,0.01045
PRJEB21503,Plasmodium falciparum,5833,S,1457,407,1864,0.01044
PRJNA1010661,Cutibacterium acnes,1747,S,943,42,985,0.01043
PRJNA912096,Bifidobacterium longum,216816,S,79,140,219,0.01031
PRJNA807746,Corynebacterium heidelbergense,2055947,S,23226,8427,31653,0.0103
PRJNA1010661,Escherichia coli,562,S,586,938,1524,0.01009
PRJNA744578,Muribaculum intestinale,1796646,S,108412,3449,111861,0.01009
PRJNA912096,Geodermatophilus obscurus,1861,S,44,2,46,0.01002
PRJNA749068,Paucibacter sp. S2-9,3019553,S,111208,1759,112967,0.01
PRJDB10133,Stenotrophomonas indicatrix,2045451,S,145,39142,39287,0.00995
PRJNA721101,Candidatus Kaistella beijingensis,2820270,S,14389,284,14673,0.00995
PRJNA912096,Faecalibacterium prausnitzii,853,S,47,134,181,0.00988
PRJNA629667,Acinetobacter baumannii,470,S,44522,40378,84900,0.0098
PRJNA629667,Dolosigranulum pigrum,29394,S,86991,355,87346,0.0098
PRJNA328002,Orthopneumovirus hominis,3049954,S,24,0,24,0.00971
PRJNA802336,Roseburia intestinalis,166486,S,8843453,1693170,10536623,0.00971
PRJNA886972,Aquabacterium olei,1296669,S,3673405,179780,3853185,0.00968
PRJNA807746,Corynebacterium afermentans,38286,S,371,34465,34836,0.00965
PRJNA744578,Streptomyces sp. CB00271,2750025,S,111306,5264,116570,0.00958
PRJNA879945,Abiotrophia defectiva,46125,S,7236,12,7248,0.00958
PRJNA721101,Acinetobacter sp. NyZ410,2929509,S,6395,7462,13857,0.00955
PRJNA720296,Corynebacterium sp. ATCC 6931,1487956,S,1479,47630,49109,0.00955
PRJNA910807,Staphylococcus capitis,29388,S,11008,42,11050,0.00955
PRJNA695410,Phocaeicola vulgatus,821,S,13036,6303,19339,0.00952
PRJNA847046,Salmonella enterica,28901,S,329,12828,13157,0.00945
PRJNA564695,Corynebacterium sanguinis,2594913,S,8796,3523,12319,0.00944
PRJNA807746,Streptococcus thermophilus,1308,S,915,23815,24730,0.00941
PRJNA629667,Corynebacterium yudongzhengii,2080740,S,82996,3570,86566,0.00941
PRJNA802336,Bifidobacterium dentium,1689,S,11329044,211001,11540045,0.00925
PRJNA910807,Streptococcus thermophilus,1308,S,242,2195,2437,0.00925
PRJNA1048377,Staphylococcus epidermidis,1282,S,28537,706,29243,0.00923
PRJDB10133,Acinetobacter baumannii,470,S,10950,9888,20838,0.00923
PRJNA807746,Moraxella osloensis,34062,S,37936,30,37966,0.00919
PRJNA328002,Brucella melitensis,29459,S,28,2429,2457,0.00918
PRJNA1044261,Pseudomonas sp. BYT-5,2944392,S,346,23596,23942,0.00914
PRJNA398289,Jouyvirus ev017,2844245,S,161212,169682,330894,0.00909
PRJNA910807,Anaerococcus sp. Marseille-Q7828,3036300,S,16599,1541,18140,0.00908
PRJNA802336,Blautia wexlerae,418240,S,9179507,965207,10144714,0.00907
PRJDB10133,Sphingobacterium multivorum,28454,S,27271,17462,44733,0.00905
PRJNA721101,Parasphingopyxis algicola,2026624,S,3848,12373,16221,0.00904
PRJDB15234,Pseudomonas aeruginosa,287,S,248,11050,11298,0.00901
PRJNA912212,Bacillus velezensis,492670,S,26669,4409,31078,0.00901
PRJDB10068,Corynebacterium glutamicum,1718,S,37,6951,6988,0.009
PRJNA818470,Klebsiella pneumoniae,573,S,203552,35359,238911,0.00899
PRJNA912212,Lawsonella clevelandensis,1528099,S,16411,78,16489,0.00898
PRJNA721101,Corynebacterium yudongzhengii,2080740,S,8443,2893,11336,0.00893
PRJNA912212,Corynebacterium pseudogenitalium,38303,S,957,17615,18572,0.00892
PRJNA1048377,Cutibacterium acnes,1747,S,5230,31,5261,0.00887
PRJEB55147,Corynebacterium tuberculostearicum,38304,S,37225,1426,38651,0.00883
PRJNA749068,Bacillus subtilis,1423,S,4163,80793,84956,0.00876
PRJEB55147,Corynebacterium kefirresidentii,1979527,S,697307,172828,870135,0.00872
PRJNA802336,Streptococcus mitis,28037,S,218647,56583,275230,0.00872
PRJNA1048377,Staphylococcus pseudintermedius,283734,S,31086,539,31625,0.00871
PRJNA912212,Streptococcus thermophilus,1308,S,823,10896,11719,0.00869
PRJNA744578,Corynebacterium glutamicum,1718,S,303,105918,106221,0.00864
PRJNA429692,Jouyvirus ev017,2844245,S,161211,169683,330894,0.00861
PRJNA807746,Allobaculum mucilyticum,2834459,S,34289,54,34343,0.00856
PRJDB10133,Achromobacter insolitus,217204,S,688,22549,23237,0.00856
PRJNA629667,Deinococcus ficus,317577,S,70562,6301,76863,0.00853
PRJNA610482,Staphylococcus lugdunensis,28035,S,8073386,535910,8609296,0.0085
PRJNA912096,Streptococcus thermophilus,1308,S,908,16833,17741,0.00848
PRJNA721101,Granulicatella adiacens,46124,S,13095,21,13116,0.00846
PRJNA629667,Sphingomonas cannabina,2899123,S,1484,69753,71237,0.00843
PRJNA720296,Comamonas terrigena,32013,S,32502,14320,46822,0.00843
PRJDB10068,Massilia oculi,945844,S,4612,2063,6675,0.00843
PRJDB15234,Bacteroides ovatus,28116,S,4063,651,4714,0.00842
PRJNA807746,Lactobacillus iners,147802,S,20419,9814,30233,0.0084
PRJNA721101,Rhizobium ruizarguesonis,2081791,S,99,19070,19169,0.0084
PRJNA720296,Comamonas thiooxydans,363952,S,1123,44633,45756,0.00839
PRJNA819236,Brevundimonas naejangsanensis,588932,S,185,30153,30338,0.00834
PRJNA879945,Comamonas flocculans,2597701,S,8084,357,8441,0.00834
PRJDB10133,Elizabethkingia bruuniana,1756149,S,34366,1478,35844,0.00833
PRJNA749068,Staphylococcus aureus,1280,S,13619,53080,66699,0.00827
PRJNA720296,Simonsiella muelleri,72,S,42313,1920,44233,0.00827
PRJNA807746,Faecalibacterium prausnitzii,853,S,18910,19806,38716,0.00825
PRJNA646315,Enterobacter kobei,208224,S,6780,28587,35367,0.00813
PRJNA1048173,Corynebacterium glutamicum,1718,S,2331,325495,327826,0.00811
PRJDB10068,Methylobacterium organophilum,410,S,145,6233,6378,0.0081
PRJNA695410,Gemmatirosa kalamazoonensis,861299,S,236,27,263,0.00807
PRJNA744578,Halomonas sp. 1513,1883416,S,76825,8437,85262,0.00804
PRJNA486134,Pseudomonas aeruginosa,287,S,199,52246,52445,0.00804
PRJNA879945,Brevibacterium sp. CS2,2575923,S,15309,150,15459,0.00802
PRJNA744578,Rhodococcus erythropolis,1833,S,2936,81490,84426,0.00801
PRJNA749068,Variovorax paradoxus,34073,S,60375,1827,62202,0.008
PRJNA328002,Mesorhizobium sp. AR07,2865838,S,1653,478,2131,0.00796
PRJNA1048377,Corynebacterium kutscheri,35755,S,368,1239,1607,0.00792
PRJNA912096,Moraxella bovoculi,386891,S,20,16200,16220,0.00791
PRJNA1010661,Clostridium botulinum,1491,S,1024,20,1044,0.00789
PRJNA894103,Streptomyces sp. CB00271,2750025,S,1439,15807,17246,0.00785
PRJNA912096,Phocaeicola vulgatus,821,S,33,15,48,0.00781
PRJNA879945,Segatella copri,165179,S,1564,6,1570,0.0078
PRJNA912212,Salmonella enterica,28901,S,414,26722,27136,0.00779
PRJNA564695,Pseudomonas sp. S150,2559074,S,73,7438,7511,0.0077
PRJNA695410,Corynebacterium glutamicum,1718,S,194,21833,22027,0.0077
PRJDB10133,Methylobacterium aquaticum,270351,S,21,16290,16311,0.0077
PRJNA912212,Pseudooceanicola algae,1537215,S,13438,17315,30753,0.00767
PRJNA629667,Stenotrophomonas maltophilia,40324,S,1152,63088,64240,0.00767
PRJNA1044261,Delftia tsuruhatensis,180282,S,279,41883,42162,0.00767
PRJNA912212,Corynebacterium kroppenstedtii,161879,S,5044,475,5519,0.00765
PRJNA912096,Ruminococcus lactaris,46228,S,53,10,63,0.00763
PRJDB10133,Chryseobacterium gambrini,373672,S,10384,542,10926,0.00762
PRJNA692666,Moraxella bovoculi,386891,S,190,15110,15300,0.0076
PRJNA749068,Salmonella enterica,28901,S,43696,43033,86729,0.00756
PRJNA802336,Allomeiothermus silvanus,52022,S,24112,293,24405,0.00753
PRJDB10133,Brevundimonas naejangsanensis,588932,S,897,38468,39365,0.00752
PRJNA721101,Lawsonella clevelandensis,1528099,S,6818,1079,7897,0.00741
PRJNA912096,Ligilactobacillus faecis,762833,S,321,57,378,0.00737
PRJNA912096,Pseudomonas guguanensis,1198456,S,104,31,135,0.00732
PRJDB15234,Methylobacterium radiotolerans,31998,S,693,2674,3367,0.00729
PRJNA610482,Staphylococcus capitis,29388,S,51771,2994,54765,0.00727
PRJNA721101,Sphingomonas cannabina,2899123,S,72,11310,11382,0.00726
PRJNA894103,Staphylococcus aureus,1280,S,8554,42882,51436,0.00721
PRJDB10068,Methylobacterium aquaticum,270351,S,69,5605,5674,0.00719
PRJNA879945,Gardnerella swidsinskii,2792979,S,304,13,317,0.00716
PRJDB15234,Phreatobacter stygius,1940610,S,1085,1928,3013,0.00715
PRJNA564695,Streptococcus agalactiae,1311,S,1298,9506,10804,0.00711
PRJNA912096,Clostridium baratii,1561,S,2178,73,2251,0.0069
PRJNA486134,Pseudomonas sp. SD17-1,2976883,S,2477,8625,11102,0.00689
PRJNA912096,Virgibacillus natechei,1216297,S,36,5,41,0.00689
PRJNA749068,Sphingobacterium multivorum,28454,S,68627,11726,80353,0.00689
PRJNA749068,Bradyrhizobium diazoefficiens,1355477,S,194,89372,89566,0.00685
PRJNA802336,Ligilactobacillus salivarius,1624,S,32,0,32,0.00684
PRJNA744578,Arthrospira platensis,118562,S,584,82015,82599,0.00681
PRJNA894103,Maliibacterium massiliense,2086585,S,24495,960,25455,0.00681
PRJNA629667,Acinetobacter sp. NyZ410,2929509,S,57506,6284,63790,0.0068
PRJNA807746,Haemophilus influenzae,727,S,278,40858,41136,0.0068
PRJNA381365,Anncaliia algerae,723287,S,145414,2,145416,0.00675
PRJDB15234,Dolosigranulum pigrum,29394,S,10056,14,10070,0.00674
PRJDB10133,Serratia inhibens,2338073,S,18839,1239,20078,0.00673
PRJNA486134,Streptococcus sp. LPB0220,2610896,S,5422,1838,7260,0.00666
PRJNA610482,Alphatorquevirus homin18,3048419,S,40391,1588,41979,0.00664
PRJNA894103,Streptococcus agalactiae,1311,S,286,24789,25075,0.00658
PRJNA610482,Alphatorquevirus homin24,3048424,S,76169,26042,102211,0.00657
PRJNA749068,Sphingomonas sp. ZFBP2030,2972485,S,78097,7264,85361,0.00648
PRJEB21503,Acinetobacter baumannii,470,S,177,1188,1365,0.00648
PRJNA912212,Bacillus anthracis,1392,S,11159,10976,22135,0.00647
PRJDB10068,Pseudomonas aeruginosa,287,S,1517,3545,5062,0.00646
PRJNA910807,Lawsonella clevelandensis,1528099,S,5757,43,5800,0.00646
PRJNA692666,Thermus scotoductus,37636,S,8769,3228,11997,0.00643
PRJDB10068,Cutibacterium acnes,1747,S,4859,83,4942,0.00639
PRJNA1010661,Staphylococcus aureus,1280,S,40,765,805,0.00639
PRJNA629667,Enterococcus faecium,1352,S,4080,52953,57033,0.00638
PRJNA744578,Ralstonia insidiosa,190721,S,73359,3731,77090,0.00638
PRJNA486134,Bradyrhizobium diazoefficiens,1355477,S,23,154,177,0.00637
PRJNA894103,Collinsella aerofaciens,74426,S,21365,64,21429,0.00635
PRJNA692666,Corynebacterium massiliense,441501,S,47,4894,4941,0.00633
PRJNA564695,Streptococcus thermophilus,1308,S,3622,3645,7267,0.00629
PRJNA912096,Collinsella aerofaciens,74426,S,200,2,202,0.00628
PRJNA721101,Rhizobium leguminosarum,384,S,39,14322,14361,0.00624
PRJNA693337,Faecalibacillus intestinalis,1982626,S,13039,1905,14944,0.00618
PRJNA692666,Streptococcus thermophilus,1308,S,735,7343,8078,0.00616
PRJNA819236,Ralstonia solanacearum,305,S,81,21623,21704,0.00615
PRJNA629667,Pseudomonas aeruginosa,287,S,6711,46648,53359,0.00614
PRJNA894103,Anaerobutyricum hallii,39488,S,15867,202,16069,0.00614
PRJNA879945,Bacillus velezensis,492670,S,27,479,506,0.00611
PRJNA802336,Streptococcus dysgalactiae,1334,S,10295,132,10427,0.0061
PRJNA912096,Paracoccus suum,2259340,S,12994,274,13268,0.00602
PRJNA564695,Corynebacterium heidelbergense,2055947,S,7630,1822,9452,0.00598
PRJNA802336,Actinomyces israelii,1659,S,8394631,99061,8493692,0.00597
PRJNA912096,Staphylococcus epidermidis,1282,S,11967,4396,16363,0.00595
PRJNA629667,Paracoccus stylophorae,659350,S,37233,14926,52159,0.00594
PRJEB21503,Paenibacillus sp. JNUCC-31,2777983,S,75,8,83,0.00592
PRJNA912096,Solibaculum mannosilyticum,2780922,S,71,70,141,0.00581
PRJNA1077663,Ralstonia solanacearum,305,S,389,34974,35363,0.00579
PRJNA749068,Oscillatoria nigro-viridis,482564,S,9272,40349,49621,0.00578
PRJNA749068,Candidatus Atelocyanobacterium thalassa,713887,S,406,45834,46240,0.00577
PRJNA629667,Anaerococcus prevotii,33034,S,50680,199,50879,0.00576
PRJNA721101,Sphingomonas sp.,28214,S,342,8499,8841,0.00574
PRJEB21503,Corynebacterium propinquum,43769,S,849,39,888,0.00573
PRJDB10133,Delftia tsuruhatensis,180282,S,254,15326,15580,0.00569
PRJNA744578,Acinetobacter baumannii,470,S,3459,64623,68082,0.00569
PRJNA749068,Rickettsia amblyommatis,33989,S,45446,22,45468,0.00567
PRJNA818470,Aspergillus novofumigatus,340412,S,253186,8027,261213,0.00567
PRJNA879945,Corynebacterium resistens,258224,S,774,5719,6493,0.00565
PRJNA689968,Blautia massiliensis (ex Durand et al. 2017),1737424,S,734,14187,14921,0.00562
PRJNA744578,Staphylococcus aureus,1280,S,5972,60900,66872,0.00559
PRJNA912212,Streptococcus pneumoniae,1313,S,459,12066,12525,0.00558
PRJDB10068,Rothia mucilaginosa,43675,S,4184,165,4349,0.00558
PRJNA629667,Streptococcus agalactiae,1311,S,2983,43335,46318,0.00554
PRJNA692666,Corynebacterium kutscheri,35755,S,7772,24,7796,0.00554
PRJNA564695,Corynebacterium accolens,38284,S,93,6456,6549,0.00551
PRJNA720296,Staphylococcus aureus,1280,S,4547,24817,29364,0.00548
PRJDB10068,Chryseobacterium sp. LJ668,2864040,S,1043,3291,4334,0.00548
PRJNA910807,Bifidobacterium longum,216816,S,319,2337,2656,0.00548
PRJNA912212,Streptococcus agalactiae,1311,S,239,13812,14051,0.00543
PRJNA1077663,Vibrio metschnikovii,28172,S,24602,1056,25658,0.00541
PRJNA486134,Bradyrhizobium sp. SK17,2057741,S,76,74,150,0.0054
PRJNA819236,Duncaniella sp. B8,2576606,S,21490,569,22059,0.00539
PRJNA564695,Pelagovum pacificum,2588711,S,10081,356,10437,0.00538
PRJNA818470,Malassezia globosa,76773,S,43538,3,43541,0.00538
PRJNA721101,Sphingobium sp. TKS,1315974,S,45,12271,12316,0.00536
PRJNA1010661,Ralstonia pickettii,329,S,693,30,723,0.00535
PRJNA910807,Collinsella aerofaciens,74426,S,1393,122,1515,0.00535
PRJNA802336,Rothia dentocariosa,2047,S,1517896,67656,1585552,0.00535
PRJDB10068,Brevibacterium sp. CS2,2575923,S,92,4096,4188,0.0053
PRJNA894103,Dietzia sp. oral taxon 368,712270,S,8185,392,8577,0.0053
PRJNA381365,Kocuria varians,1272,S,49174,3984,53158,0.00527
PRJNA692666,Corynebacterium capitovis,131081,S,92,4408,4500,0.00524
PRJDB10133,Kocuria indica,1049583,S,66,11610,11676,0.00522
PRJDB10133,Caulobacter segnis,88688,S,5035,2648,7683,0.0052
PRJNA744578,Desulfovibrio piger,901,S,52124,12955,65079,0.0052
PRJNA721101,Corynebacterium urealyticum,43771,S,154,3461,3615,0.00513
PRJNA912212,Lactobacillus taiwanensis,508451,S,876,1492,2368,0.00511
PRJNA398289,Enterococcus faecium,1352,S,86211,11689,97900,0.0051
PRJDB10133,Methylobacterium organophilum,410,S,268,15798,16066,0.00508
PRJNA807746,Corynebacterium kutscheri,35755,S,2811,10018,12829,0.00507
PRJNA879945,Sellimonas intestinalis,1653434,S,13507,261,13768,0.00507
PRJNA695410,Solibaculum mannosilyticum,2780922,S,9919,1891,11810,0.00504
PRJNA910807,Acinetobacter schindleri,108981,S,377,7,384,0.00504
PRJNA910807,Corynebacterium yudongzhengii,2080740,S,219,815,1034,0.00502
PRJNA749068,Cutibacterium acnes,1747,S,43430,90,43520,0.005
PRJNA564695,Anoxybacillus caldiproteolyticus,247480,S,4901,369,5270,0.00499
PRJNA912096,Hydrogenophilus thermoluteolus,297,S,28,1,29,0.00496
PRJNA564695,Corynebacterium kutscheri,35755,S,7781,20,7801,0.00494
PRJNA398289,Moraxella osloensis,34062,S,4572566,52605,4625171,0.00494
PRJNA894103,Anaerostipes hadrus,649756,S,14302,306,14608,0.00492
PRJNA818470,Staphylococcus aureus,1280,S,29478,49076,78554,0.00488
PRJNA912212,Finegoldia magna,1260,S,5158,21,5179,0.00487
PRJNA879945,Staphylococcus simulans,1286,S,252,8,260,0.00485
PRJNA429692,Enterococcus faecium,1352,S,86211,11689,97900,0.00483
PRJNA819236,Bacteroides caecimuris,1796613,S,16565,3277,19842,0.00482
PRJNA610482,Staphylococcus equorum,246432,S,324574,697532,1022106,0.00482
PRJNA807746,Gardnerella swidsinskii,2792979,S,10422,123,10545,0.00482
PRJNA910807,Finegoldia magna,1260,S,3803,25,3828,0.0048
PRJNA912096,Blautia obeum,40520,S,20,8,28,0.00479
PRJNA720296,Humisphaera borealis,2807512,S,25211,0,25211,0.00478
PRJNA1048173,Corynebacterium yudongzhengii,2080740,S,174468,10184,184652,0.00475
PRJNA646315,Segatella copri,165179,S,6369,705,7074,0.00474
PRJNA721101,Mammaliicoccus vitulinus,71237,S,4217,850,5067,0.00474
PRJDB10133,Comamonas thiooxydans,363952,S,45,13620,13665,0.00473
PRJNA894103,Corynebacterium bovis,36808,S,11775,4438,16213,0.00471
PRJNA720296,Phocaeicola vulgatus,821,S,22402,3488,25890,0.0047
PRJNA486134,Burkholderia contaminans,488447,S,824,1840,2664,0.0047
PRJDB10068,Comamonas antarctica,2743470,S,23,3692,3715,0.0047
PRJNA486134,Bradyrhizobium sp. BTAi1,288000,S,95,35,130,0.00468
PRJNA429692,Moraxella osloensis,34062,S,5612097,70915,5683012,0.00468
PRJNA802336,Mycobacterium branderi,43348,S,3184,0,3184,0.00467
PRJNA912096,Cupriavidus pauculus,82633,S,5720,17,5737,0.00466
PRJDB10133,Delftia lacustris,558537,S,93,12194,12287,0.00466
PRJNA802336,Haemophilus parainfluenzae,729,S,11882085,637076,12519161,0.00465
PRJNA610482,Halomonas sp. HAL1,550984,S,53007,1129,54136,0.00465
PRJNA1044261,Pseudomonas sp. MPDS,2762896,S,597,1455,2052,0.00465
PRJNA1010661,Streptococcus thermophilus,1308,S,671,31,702,0.00465
PRJNA720296,Corynebacterium glutamicum,1718,S,60,22596,22656,0.00463
PRJNA721101,Rhizobium sp. CC-CFT758,2926709,S,51,10907,10958,0.00463
PRJNA819236,Bacteroides salyersiae,291644,S,18467,515,18982,0.00461
PRJNA912212,Shewanella sp. Pdp11,2059264,S,1510,4478,5988,0.0046
PRJNA912212,Oscillatoria nigro-viridis,482564,S,164,5689,5853,0.00459
PRJNA721101,Muribaculum intestinale,1796646,S,4386,150,4536,0.00458
PRJNA912096,Corynebacterium sp. SCR221107,3017361,S,31,3,34,0.00457
PRJNA894103,Dorea longicatena,88431,S,11176,130,11306,0.00452
PRJNA1077663,Synechococcus sp. JA-3-3Ab,321327,S,39,19958,19997,0.00451
PRJDB10068,Veillonella rogosae,423477,S,1628,1907,3535,0.00451
PRJNA749068,Muribaculum intestinale,1796646,S,32,4,36,0.00449
PRJNA912212,Bacillus thuringiensis,1428,S,8608,6682,15290,0.00448
PRJNA912096,Clostridium perfringens,1502,S,1292,161,1453,0.00446
PRJEB21503,Acinetobacter johnsonii,40214,S,196,210,406,0.00446
PRJNA807746,Phocaeicola vulgatus,821,S,12503,1973,14476,0.00446
PRJNA486134,Cutibacterium acnes,1747,S,5180,13214,18394,0.00445
PRJNA629667,Pseudomonas sp. S150,2559074,S,307,41446,41753,0.00444
PRJNA910807,Corynebacterium glucuronolyticum,39791,S,73,58,131,0.00443
PRJNA879945,Haemophilus parainfluenzae,729,S,360,2,362,0.00441
PRJNA629667,Sphingomonas sanxanigenens,397260,S,284,38513,38797,0.00441
PRJNA1048377,Staphylococcus saccharolyticus,33028,S,47103,300,47403,0.00439
PRJNA912212,Lactobacillus iners,147802,S,5873,60,5933,0.00438
PRJNA894103,Corynebacterium accolens,38284,S,73,14384,14457,0.00438
PRJDB10133,Pseudomonas sp. BYT-5,2944392,S,80,7744,7824,0.00437
PRJNA912212,Acinetobacter baumannii,470,S,2572,10391,12963,0.00434
PRJNA894103,Ruminococcus lactaris,46228,S,14904,106,15010,0.00433
PRJNA642342,Blautia massiliensis (ex Durand et al. 2017),1737424,S,704,8827,9531,0.00433
PRJDB10068,Acinetobacter radioresistens,40216,S,3357,56,3413,0.00431
PRJNA721101,Corynebacterium kutscheri,35755,S,324,6257,6581,0.00431
PRJDB10068,Lawsonella clevelandensis,1528099,S,3301,29,3330,0.00431
PRJNA692666,Phocaeicola vulgatus,821,S,8380,3157,11537,0.00428
PRJDB10133,Chloracidobacterium validum,2821543,S,5764,340,6104,0.00428
PRJNA749068,Ralstonia solanacearum,305,S,759,49936,50695,0.00427
PRJNA486134,Pedobacter cryoconitis,188932,S,32,28,60,0.00427
PRJEB21503,Janthinobacterium sp. PAMC25594,2861284,S,348,97,445,0.00424
PRJDB10133,Bradyrhizobium diazoefficiens,1355477,S,311,14020,14331,0.00424
PRJNA1010661,Sphingomonas paucimobilis,13689,S,451,111,562,0.00424
PRJNA1048377,Bacillus sp. ZHX3,2841656,S,774,3559,4333,0.00423
PRJNA692666,Segatella copri,165179,S,10963,77,11040,0.00423
PRJNA642342,Collinsella aerofaciens,74426,S,4269,461,4730,0.00422
PRJNA1044261,Paucibacter sp. S2-9,3019553,S,25645,297,25942,0.00422
PRJNA629667,Staphylococcus condimenti,70255,S,36751,697,37448,0.00419
PRJNA692666,Corynebacterium kroppenstedtii,161879,S,200,3942,4142,0.00419
PRJDB10068,Methylobacterium sp. 17Sr1-1,2202826,S,43,3252,3295,0.00418
PRJNA894103,Corynebacterium sp. ATCC 6931,1487956,S,101,18047,18148,0.00418
PRJNA912212,Haemophilus parainfluenzae,729,S,7787,988,8775,0.00418
PRJNA692666,Streptococcus agalactiae,1311,S,122,5771,5893,0.00417
PRJNA695410,Staphylococcus aureus,1280,S,1409,9008,10417,0.00417
PRJNA744578,Streptococcus pneumoniae,1313,S,1343,51150,52493,0.00416
PRJNA629667,Staphylococcus epidermidis,1282,S,36529,638,37167,0.00416
PRJNA879945,Veillonella atypica,39777,S,114,227,341,0.00415
PRJNA486134,Schizosaccharomyces pombe,4896,S,56,2,58,0.00413
PRJNA721101,Corynebacterium heidelbergense,2055947,S,6156,638,6794,0.00412
PRJEB21503,Paracoccus yeei,147645,S,26,5,31,0.00412
PRJNA692666,Faecalibaculum rodentium,1702221,S,10267,112,10379,0.00409
PRJDB15234,Bifidobacterium longum,216816,S,1504,1979,3483,0.00408
PRJNA1048377,Staphylococcus haemolyticus,1283,S,80757,3000,83757,0.00407
PRJNA802336,Fusobacterium pseudoperiodonticum,2663009,S,18,1,19,0.00406
PRJNA744578,Rhodococcus sp. ZPP,2749906,S,244,45431,45675,0.00406
PRJNA564695,Finegoldia magna,1260,S,5051,12,5063,0.00405
PRJNA910807,Tepidimonas taiwanensis,307486,S,136,4,140,0.00404
PRJDB10133,Sphingobium phenoxybenzoativorans,1592790,S,147,23966,24113,0.00403
PRJNA720296,Microcystis sp. MC19,1967666,S,42,21455,21497,0.00402
PRJEB21503,Paenibacillus pabuli,1472,S,79,6,85,0.00401
PRJDB10133,Pseudomonas sp. HN2,2884805,S,5988,12922,18910,0.00401
PRJDB10133,Lactobacillus delbrueckii,1584,S,9200,237,9437,0.004
PRJNA912212,Corynebacterium callunae,1721,S,3680,2330,6010,0.00398
PRJNA744578,Rickettsia amblyommatis,33989,S,47987,48,48035,0.00397
PRJNA802336,Streptococcus salivarius,1304,S,3685636,1046773,4732409,0.00397
PRJNA564695,Psychrobacter sp. WY6,2708350,S,3474,247,3721,0.00396
PRJNA693337,Ruminococcus lactaris,46228,S,10239,880,11119,0.00396
PRJNA847046,Neisseria gonorrhoeae,485,S,12565,1945,14510,0.00392
PRJNA629667,Cutibacterium acnes,1747,S,31598,335,31933,0.0039
PRJDB10068,Kocuria palustris,71999,S,1735,1309,3044,0.00389
PRJDB15234,Rhizobium gallicum,56730,S,80,3523,3603,0.00388
PRJNA744578,Rhizobium sp. CC-CFT758,2926709,S,235,49363,49598,0.00388
PRJNA745199,Penicillium rubens,1108849,S,4532,6,4538,0.00388
PRJNA749068,Stenotrophomonas maltophilia,40324,S,1726,14920,16646,0.00387
PRJNA807746,Haemophilus parainfluenzae,729,S,1085,9086,10171,0.00387
PRJNA486134,Salmonella enterica,28901,S,46,25107,25153,0.00386
PRJNA610482,Staphylococcus lloydii,2781774,S,1028099,29339,1057438,0.00383
PRJNA807746,Acetobacter aceti,435,S,10900,572,11472,0.00383
PRJNA879945,Brachybacterium faecium,43669,S,6928,468,7396,0.00383
PRJNA802336,Enterococcus faecalis,1351,S,5518547,3572415,9090962,0.00382
PRJNA912212,Bacillus sp. ZHX3,2841656,S,72,8106,8178,0.00381
PRJNA807746,Fusobacterium varium,856,S,5869,1317,7186,0.00381
PRJNA807746,Paracoccus stylophorae,659350,S,7422,1877,9299,0.0038
PRJNA744578,Duncaniella sp. B8,2576606,S,38921,1628,40549,0.00379
PRJDB10133,Microbacterium sp. KACC 23027,3028316,S,2836,16347,19183,0.00378
PRJNA629667,Deinococcus deserti,310783,S,30632,1873,32505,0.00378
PRJNA802336,Staphylococcus epidermidis,1282,S,13163,920,14083,0.00377
PRJNA692666,Solibaculum mannosilyticum,2780922,S,6296,896,7192,0.00376
PRJNA610482,Escherichia coli,562,S,27100,29050,56150,0.00375
PRJDB10133,Moraxella osloensis,34062,S,1849,14,1863,0.00375
PRJDB15234,Aeribacillus pallidus,33936,S,5294,1772,7066,0.00373
PRJNA912212,Ralstonia sp. RS642,2880988,S,132,12464,12596,0.00373
PRJNA802336,Enterococcus avium,33945,S,8227208,598176,8825384,0.00373
PRJDB15234,Prevotella corporis,28128,S,1420,2618,4038,0.00372
PRJNA629667,Peptoniphilus harei,54005,S,31931,281,32212,0.00372
PRJNA381365,Aspergillus flavus,5059,S,7811,12423,20234,0.00371
PRJNA721101,Corynebacterium jeikeium,38289,S,5365,358,5723,0.0037
PRJNA802336,Enterococcus gallinarum,1353,S,1859955,6796926,8656881,0.00367
PRJDB10068,Chryseobacterium camelliae,1265445,S,2310,532,2842,0.00363
PRJNA879945,Providencia stuartii,588,S,541,1913,2454,0.00361
PRJNA689968,Bifidobacterium animalis,28025,S,2255,4334,6589,0.0036
PRJNA1010661,Ralstonia insidiosa,190721,S,428,58,486,0.00359
PRJDB10068,Rhizobium gallicum,56730,S,20,2816,2836,0.00359
PRJNA807746,Acetobacter vaccinii,2592655,S,6400,7777,14177,0.00358
PRJNA381365,Aspergillus oryzae,5062,S,7665,11807,19472,0.00357
PRJDB10133,Achromobacter xylosoxidans,85698,S,383,13154,13537,0.00357
PRJDB10133,Fluviicola taffensis,191579,S,20796,209,21005,0.00356
PRJNA629667,Haemophilus influenzae,727,S,24946,9422,34368,0.00354
PRJDB10133,Chryseobacterium sp. LJ668,2864040,S,8578,614,9192,0.00354
PRJNA1010661,Novosphingobium sp. EMRT-2,2571749,S,406,170,576,0.00352
PRJNA749068,Ralstonia insidiosa,190721,S,44263,507,44770,0.00351
PRJNA847046,Megasphaera elsdenii,907,S,13711,82,13793,0.0035
PRJNA910807,Moraxella osloensis,34062,S,621,12,633,0.0035
PRJNA721101,Pseudomonas sp. HN2,2884805,S,1181,6544,7725,0.0035
PRJNA610482,Staphylococcus haemolyticus,1283,S,29707,6227,35934,0.00349
PRJNA910807,Blautia sp. SC05B48,2479767,S,106,143,249,0.00347
PRJNA692666,Corynebacterium heidelbergense,2055947,S,2999,1234,4233,0.00347
PRJNA689968,Collinsella aerofaciens,74426,S,4269,461,4730,0.00345
PRJNA695410,Corynebacterium sp. ATCC 6931,1487956,S,268,8373,8641,0.00345
PRJNA879945,Streptococcus pneumoniae,1313,S,33,2540,2573,0.00345
PRJNA721101,Corynebacterium glucuronolyticum,39791,S,1488,2585,4073,0.00342
PRJNA910807,Corynebacterium jeddahense,1414719,S,164,674,838,0.00341
PRJNA910807,Ruminococcus lactaris,46228,S,524,19,543,0.0034
PRJDB10133,Roseomonas sp. OT10,2897332,S,235,11489,11724,0.0034
PRJNA879945,Streptococcus intermedius,1338,S,19,2549,2568,0.00339
PRJNA692666,Chryseobacterium sp. 6424,2039166,S,1653,1961,3614,0.00339
PRJNA802336,Prevotella oris,28135,S,286995,15699,302694,0.00338
PRJNA720296,Mycoplasma sp. (ex Gorgonocephalus chilensis),3004105,S,16287,34,16321,0.00338
PRJNA749068,Acinetobacter sp. AOR07_HL,2919376,S,399,38849,39248,0.00338
PRJNA429692,Pseudomonas sp. FDAARGOS_380,2018067,S,5946520,1807659,7754179,0.00337
PRJEB21503,Candidatus Planktophila sulfonica,1884904,S,49,9,58,0.00337
PRJNA912212,Pseudomonas aeruginosa,287,S,122,4594,4716,0.00336
PRJNA721101,Corynebacterium aquatimens,1190508,S,116,5808,5924,0.00336
PRJNA721101,Deinococcus deserti,310783,S,4922,13,4935,0.00335
PRJNA398289,Paracoccus sp. SMMA_5_TC,2654280,S,1189867,43218,1233085,0.00334
PRJNA692666,Finegoldia magna,1260,S,3714,8,3722,0.00334
PRJEB21503,Bradyrhizobium sp. 6(2017),1197460,S,164,62,226,0.00333
PRJNA1077663,Arthrospira platensis,118562,S,29,14693,14722,0.00332
PRJNA807746,Schleiferilactobacillus harbinensis,304207,S,14004,307,14311,0.00332
PRJNA879945,Brevundimonas naejangsanensis,588932,S,2054,147,2201,0.00332
PRJNA629667,Acinetobacter ursingii,108980,S,31913,24,31937,0.0033
PRJNA894103,Lactobacillus delbrueckii,1584,S,5891,1940,7831,0.00329
PRJNA847046,Segatella copri,165179,S,11198,122,11320,0.00329
PRJDB10133,Weissella ceti,759620,S,135,5470,5605,0.00328
PRJNA819236,Ralstonia insidiosa,190721,S,48,11148,11196,0.00328
PRJNA381365,Acanthamoeba lugdunensis,61605,S,7748,1306,9054,0.00328
PRJNA910807,Streptococcus sanguinis,1305,S,137,442,579,0.00328
PRJNA1077663,Staphylococcus aureus,1280,S,802,16118,16920,0.00328
PRJNA807746,Helicobacter apodemus,135569,S,18565,19,18584,0.00327
PRJNA629667,Staphylococcus saccharolyticus,33028,S,28012,241,28253,0.00327
PRJNA879945,Advenella alkanexedens,1481665,S,4101,176,4277,0.00326
PRJNA912096,Lawsonella clevelandensis,1528099,S,19,0,19,0.00325
PRJNA693337,Bacillus cereus,1396,S,1053,14843,15896,0.00325
PRJNA910807,Leptotrichia hongkongensis,554406,S,67,0,67,0.00325
PRJNA629667,Staphylococcus capitis,29388,S,28740,129,28869,0.00324
PRJNA912096,Raineyella fluvialis,2662261,S,24,0,24,0.00322
PRJNA629667,Empedobacter falsenii,343874,S,29366,1052,30418,0.00321
PRJNA807746,Corynebacterium maris,575200,S,367,9232,9599,0.0032
PRJNA629667,Vitreoscilla massiliensis,1689272,S,11403,17525,28928,0.0032
PRJNA749068,Ralstonia sp. RS647,2880989,S,109,35513,35622,0.0032
PRJNA879945,Escherichia coli,562,S,19,652,671,0.0032
PRJNA629667,Haemophilus parainfluenzae,729,S,25763,1078,26841,0.0032
PRJNA629667,Enterococcus faecalis,1351,S,1936,22537,24473,0.00318
PRJNA610482,Phocaeicola vulgatus,821,S,13572,3369,16941,0.00317
PRJNA429692,Paracoccus sp. SMMA_5_TC,2654280,S,1189861,43218,1233079,0.00316
PRJNA629667,Sphingomonas profundi,2681549,S,2147,24665,26812,0.00315
PRJDB15234,Simonsiella muelleri,72,S,3070,31,3101,0.00314
PRJEB55147,Staphylococcus hominis,1290,S,47551,2824,50375,0.00314
PRJNA720296,Halomicronema hongdechloris,1209493,S,181,16896,17077,0.00314
PRJDB15234,Marvinbryantia formatexigens,168384,S,2412,37,2449,0.00313
PRJNA610482,Acinetobacter baumannii,470,S,642436,20476,662912,0.00312
PRJNA720296,Megamonas funiformis,437897,S,16713,296,17009,0.0031
PRJEB55147,Stenotrophomonas indicatrix,2045451,S,149373,594,149967,0.0031
PRJNA1077663,Methylobacterium organophilum,410,S,2369,7408,9777,0.00309
PRJDB10133,Herbaspirillum huttiense,863372,S,15174,702,15876,0.00309
PRJNA721101,Prevotella intermedia,28131,S,5485,114,5599,0.00307
PRJNA629667,Morganella morganii,582,S,26435,32,26467,0.00307
PRJDB10133,Chryseobacterium carnipullorum,1124835,S,9053,1341,10394,0.00307
PRJNA721101,Sphingobium sp. SYK-6,627192,S,29,6872,6901,0.00306
PRJNA744578,Anabaena sp. YBS01,2490939,S,138,37369,37507,0.00305
PRJNA629667,Sphingomonas naphthae,1813468,S,601,23353,23954,0.00304
PRJNA910807,Corynebacterium pseudogenitalium,38303,S,33,1260,1293,0.00304
PRJNA398289,Cutibacterium modestum,2559073,S,1415919,54136,1470055,0.00303
PRJNA807746,Rhizobium sp. TH2,2775403,S,174,9276,9450,0.00301
PRJNA749068,Bacillus spizizenii,96241,S,2521,16,2537,0.00301
PRJNA879945,Bacillus sp. S3,486398,S,74,174,248,0.003
PRJNA879945,Kocuria palustris,71999,S,5242,520,5762,0.00299
PRJNA721101,Faecalibacterium prausnitzii,853,S,2944,3481,6425,0.00296
PRJNA912096,Enterococcus faecalis,1351,S,487,2415,2902,0.00295
PRJNA721101,Haematobacter massiliensis,195105,S,4409,43,4452,0.00294
PRJNA721101,Staphylococcus epidermidis,1282,S,4214,834,5048,0.00292
PRJNA912212,Corynebacterium glucuronolyticum,39791,S,299,1378,1677,0.00292
PRJNA720296,Oceanobacillus iheyensis,182710,S,16342,252,16594,0.00291
PRJNA642342,Paludibaculum fermentans,1473598,S,5842,18,5860,0.00291
PRJNA910807,Parabacteroides merdae,46503,S,37,23,60,0.00291
PRJDB10133,Sphingobium chlorophenolicum,46429,S,112,18050,18162,0.0029
PRJNA629667,Moraxella bovis,476,S,24407,1374,25781,0.00289
PRJNA1048173,Moraxella osloensis,34062,S,105769,324,106093,0.00289
PRJNA807746,Bacteroides ovatus,28116,S,11248,2606,13854,0.00287
PRJNA1048377,Corynebacterium kroppenstedtii,161879,S,87,610,697,0.00287
PRJNA429692,Cutibacterium modestum,2559073,S,1415919,54136,1470055,0.00287
PRJNA749068,Pseudomonas sp. S150,2559074,S,185,35406,35591,0.00286
PRJNA692666,Haemophilus parainfluenzae,729,S,4351,146,4497,0.00285
PRJNA912212,Paraburkholderia fungorum,134537,S,5906,2900,8806,0.00284
PRJNA807746,Salmonella enterica,28901,S,594,10519,11113,0.00284
PRJNA912212,Corynebacterium ulcerans,65058,S,62,1616,1678,0.00284
PRJNA629667,Kinneretia sp. DAIF2,2714952,S,16483,5822,22305,0.00283
PRJNA629667,Corynebacterium kutscheri,35755,S,24876,57,24933,0.0028
PRJNA1044261,Acinetobacter sp. NyZ410,2929509,S,10829,842,11671,0.0028
PRJNA819236,Sphingomonas profundi,2681549,S,9719,435,10154,0.0028
PRJEB21503,Caulobacter segnis,88688,S,19,2,21,0.00279
PRJNA1048377,Simonsiella muelleri,72,S,3853,76,3929,0.00278
PRJDB10133,Sphingobium yanoikuyae,13690,S,585,7350,7935,0.00277
PRJDB10133,Pseudomonas putida,303,S,3361,2372,5733,0.00277
PRJNA894103,Streptococcus thermophilus,1308,S,475,6793,7268,0.00277
PRJNA749068,Duncaniella sp. B8,2576606,S,21,1,22,0.00274
PRJNA721101,Lysobacter maris,1605891,S,1020,3017,4037,0.00274
PRJNA693337,Corynebacterium sp. ATCC 6931,1487956,S,77,15848,15925,0.00273
PRJNA910807,Roseburia intestinalis,166486,S,514,114,628,0.00272
PRJNA564695,Streptococcus pneumoniae,1313,S,452,4053,4505,0.00271
PRJNA912212,Burkholderia mallei,13373,S,28,3469,3497,0.00269
PRJNA1048377,Acinetobacter baumannii,470,S,171,507,678,0.00269
PRJNA912096,Akkermansia muciniphila,239935,S,17,0,17,0.00269
PRJNA629667,Ralstonia solanacearum,305,S,184,21266,21450,0.00269
PRJNA749068,Bacillus cereus,1396,S,2555,19582,22137,0.00268
PRJNA847046,Prevotella melaninogenica,28132,S,8463,2163,10626,0.00267
PRJNA692666,Streptococcus pneumoniae,1313,S,93,3700,3793,0.00267
PRJNA807746,Stenotrophomonas maltophilia,40324,S,105,10463,10568,0.00266
PRJNA819236,Prevotella denticola,28129,S,2858,8084,10942,0.00266
PRJNA879945,Alicycliphilus denitrificans,179636,S,2232,25,2257,0.00266
PRJNA807746,Streptococcus agalactiae,1311,S,79,14391,14470,0.00265
PRJDB15234,Rothia kristinae,37923,S,11985,467,12452,0.00265
PRJNA564695,Dolosigranulum pigrum,29394,S,3490,7,3497,0.00264
PRJNA807746,Corynebacterium yudongzhengii,2080740,S,2850,4910,7760,0.00264
PRJNA807746,Corynebacterium pseudogenitalium,38303,S,50,9733,9783,0.00264
PRJNA1077663,Simonsiella muelleri,72,S,14554,594,15148,0.00261
PRJNA629667,Streptococcus pneumoniae,1313,S,1957,20148,22105,0.0026
PRJNA610482,Corynebacterium tuberculostearicum,38304,S,5092,164,5256,0.00259
PRJNA398289,Klebsiella pneumoniae,573,S,1154887,129216,1284103,0.00259
PRJDB15234,Ligilactobacillus ruminis,1623,S,119,2349,2468,0.00257
PRJDB15234,Butyrivibrio fibrisolvens,831,S,686,22,708,0.00257
PRJNA692666,Corynebacterium accolens,38284,S,18,4199,4217,0.00257
PRJNA807746,Paucibacter sp. S2-9,3019553,S,2875,62,2937,0.00256
PRJNA1077663,Lentilactobacillus parabuchneri,152331,S,13909,384,14293,0.00255
PRJNA807746,Streptococcus sanguinis,1305,S,48,2219,2267,0.00255
PRJNA564695,Lawsonella clevelandensis,1528099,S,3565,1,3566,0.00255
PRJNA802336,Streptococcus anginosus,1328,S,1740299,1300493,3040792,0.00255
PRJDB15234,Mesorhizobium terrae,2725666,S,40,366,406,0.00255
PRJNA894103,Corynebacterium massiliense,441501,S,68,7133,7201,0.00254
PRJEB55147,Kocuria rosea,1275,S,736891,6144,743035,0.00254
PRJDB10133,Mycolicibacterium aubagnense,319707,S,4126,1618,5744,0.00253
PRJNA692666,Rothia mucilaginosa,43675,S,4229,18,4247,0.00252
PRJNA564695,Haemophilus parainfluenzae,729,S,4431,162,4593,0.00251
PRJNA879945,Actinomyces procaprae,2560010,S,3287,5,3292,0.00251
PRJNA879945,Ligilactobacillus salivarius,1624,S,91,2926,3017,0.0025
PRJNA1044261,Simonsiella muelleri,72,S,12757,215,12972,0.0025
PRJNA807746,Roseburia intestinalis,166486,S,2680,8413,11093,0.00248
PRJNA721101,Staphylococcus capitis,29388,S,3164,755,3919,0.00248
PRJNA894103,Peduovirus P22H1,2844217,S,2316,3808,6124,0.00247
PRJDB15234,Enterocloster asparagiformis,333367,S,1139,18,1157,0.00247
PRJNA807746,Dechloromonas sp. A34,447588,S,3813,39,3852,0.00247
PRJNA429692,Klebsiella pneumoniae,573,S,1154886,129215,1284101,0.00245
PRJNA912212,Corynebacterium glutamicum,1718,S,16,5954,5970,0.00245
PRJNA1048173,Simonsiella muelleri,72,S,85897,1996,87893,0.00244
PRJNA749068,Bacillus sp. CMF12,2884834,S,331,19519,19850,0.00242
PRJNA879945,Pseudomonas guguanensis,1198456,S,41,1414,1455,0.00242
PRJDB10133,Jouyvirus ev017,2844245,S,338,1666,2004,0.00242
PRJNA912212,Fenollaria massiliensis,938288,S,4346,51,4397,0.00242
PRJNA912096,Anaerobutyricum hallii,39488,S,51,0,51,0.0024
PRJNA692666,Enterococcus faecium,1352,S,703,4772,5475,0.00239
PRJNA695410,Bifidobacterium breve,1685,S,5527,375,5902,0.00238
PRJNA819236,Pseudomonas putida,303,S,4223,4396,8619,0.00238
PRJNA642342,Bifidobacterium animalis,28025,S,931,1611,2542,0.00238
PRJNA689968,Paludibaculum fermentans,1473598,S,5842,18,5860,0.00238
PRJNA629667,Chryseobacterium sp. ZHDP1,2838877,S,15807,2888,18695,0.00238
PRJNA910807,Prevotella sp. oral taxon 299,652716,S,115,27,142,0.00237
PRJNA610482,Acinetobacter pseudolwoffii,2053287,S,17396,302,17698,0.00237
PRJNA894103,Corynebacterium afermentans,38286,S,93,4168,4261,0.00237
PRJNA749068,Kaistia sp. 32K,2795690,S,30503,9,30512,0.00235
PRJNA807746,Paroceanicella profunda,2579971,S,5051,135,5186,0.00234
PRJNA807746,Acinetobacter baumannii,470,S,202,5925,6127,0.00234
PRJEB21503,Corynebacterium accolens,38284,S,283,78,361,0.00233
PRJNA646315,Pseudomonas azotoformans,47878,S,3772,2051,5823,0.00233
PRJNA910807,Corynebacterium urealyticum,43771,S,22,47,69,0.00233
PRJNA894103,Corynebacterium yudongzhengii,2080740,S,406,7977,8383,0.00232
PRJNA749068,Arthrospira platensis,118562,S,523,18247,18770,0.00232
PRJNA894103,Nocardia sp. PE-7,3058426,S,5852,190,6042,0.00232
PRJNA749068,Bradyrhizobium barranii,2992140,S,973,13973,14946,0.00231
PRJEB55147,Acinetobacter junii,40215,S,168693,19206,187899,0.00231
PRJNA749068,Enterococcus faecalis,1351,S,8251,19779,28030,0.00231
PRJNA894103,Faecalibacillus intestinalis,1982626,S,6529,232,6761,0.00231
PRJNA912096,Neisseria lactamica,486,S,23,2908,2931,0.0023
PRJNA564695,Staphylococcus epidermidis,1282,S,2921,49,2970,0.0023
PRJEB21503,Jouyvirus ev017,2844245,S,67,18,85,0.0023
PRJDB15234,Staphylococcus epidermidis,1282,S,5048,106,5154,0.00229
PRJNA744578,Faecalibaculum rodentium,1702221,S,25684,482,26166,0.00229
PRJNA879945,Ruminococcus bovis,2564099,S,5731,494,6225,0.00229
PRJDB10133,Acinetobacter johnsonii,40214,S,4280,121,4401,0.00228
PRJNA693337,Corynebacterium kroppenstedtii,161879,S,8263,806,9069,0.00228
PRJNA693337,Blautia obeum,40520,S,4395,1632,6027,0.00228
PRJNA629667,Moraxella bovoculi,386891,S,13869,5590,19459,0.00227
PRJNA398289,Staphylococcus warneri,1292,S,433038,128813,561851,0.00227
PRJNA847046,Solibaculum mannosilyticum,2780922,S,8041,858,8899,0.00226
PRJNA807746,Brevundimonas vitisensis,2800818,S,373,9379,9752,0.00226
PRJNA879945,Paracoccus tegillarcae,1529068,S,182,1506,1688,0.00226
PRJNA802336,Corynebacterium matruchotii,43768,S,665113,2047,667160,0.00225
PRJNA642342,Bifidobacterium adolescentis,1680,S,4797,324,5121,0.00224
PRJNA721101,Streptococcus agalactiae,1311,S,18,4691,4709,0.00224
PRJNA749068,Bacillus anthracis,1392,S,654,25641,26295,0.00224
PRJNA749068,Ligilactobacillus ruminis,1623,S,25159,3383,28542,0.00224
PRJNA879945,Klebsiella pneumoniae,573,S,131,242,373,0.00223
PRJNA910807,Peptoniphilus harei,54005,S,2326,49,2375,0.00223
PRJNA847046,Bartonella krasnovii,2267275,S,6845,2,6847,0.00222
PRJDB10133,Flavobacterium columnare,996,S,235,11104,11339,0.00222
PRJNA693337,Anaerobutyricum hallii,39488,S,4957,1249,6206,0.00221
PRJNA847046,Faecalibacterium prausnitzii,853,S,2228,6499,8727,0.00221
PRJNA629667,Sphingomonas changnyeongensis,2698679,S,2227,15677,17904,0.0022
PRJNA912212,Streptococcus equi,1336,S,1917,129,2046,0.0022
PRJNA629667,Sphingobium sp. SYK-6,627192,S,98,18345,18443,0.00219
PRJNA721101,Segatella copri,165179,S,5362,0,5362,0.00218
PRJNA610482,Ralstonia insidiosa,190721,S,32389,1124,33513,0.00218
PRJNA744578,Synechococcus sp. MVIR-18-1,1386941,S,1049,23355,24404,0.00217
PRJNA749068,Simonsiella muelleri,72,S,25044,556,25600,0.00217
PRJNA807746,Bacteroides fragilis,817,S,333,4197,4530,0.00217
PRJNA564695,Chryseobacterium sp. 6424,2039166,S,1541,655,2196,0.00216
PRJDB10133,Sphingobacterium spiritivorum,258,S,10102,77,10179,0.00216
PRJNA879945,Helicobacter typhlonius,76936,S,1287,11,1298,0.00216
PRJNA807746,Caldibacillus thermoamylovorans,35841,S,4354,2,4356,0.00216
PRJNA1048173,Simplicispira suum,2109915,S,80965,2948,83913,0.00215
PRJNA912212,Corynebacterium bovis,36808,S,460,30,490,0.00215
PRJNA721101,Streptococcus pneumoniae,1313,S,25,3413,3438,0.00215
PRJNA912212,Corynebacterium jeikeium,38289,S,211,2525,2736,0.00215
PRJNA429692,Staphylococcus warneri,1292,S,433038,128814,561852,0.00215
PRJNA610482,Torque teno virus 12,687351,S,26569,0,26569,0.00214
PRJNA564695,Corynebacterium phocae,161895,S,2389,660,3049,0.00214
PRJNA879945,Brevundimonas pondensis,2774189,S,985,3145,4130,0.00214
PRJDB15234,Sphingomonas cannabina,2899123,S,337,4487,4824,0.00214
PRJNA692666,Muribaculum intestinale,1796646,S,5360,340,5700,0.00213
PRJNA564695,Rothia mucilaginosa,43675,S,4276,15,4291,0.00213
PRJNA744578,Capnocytophaga sputigena,1019,S,25131,677,25808,0.00213
PRJNA692666,Corynebacterium sanguinis,2594913,S,2597,136,2733,0.00212
PRJNA912096,Staphylococcus capitis,29388,S,23,39,62,0.00211
PRJNA749068,Halomonas tianxiuensis,2497861,S,27922,362,28284,0.00211
PRJNA912096,Acetivibrio saccincola,1677857,S,19,2,21,0.0021
PRJNA894103,Lacticaseibacillus paracasei,1597,S,140,5300,5440,0.0021
PRJNA744578,Gloeocapsa sp. PCC 7428,1173026,S,86,25339,25425,0.0021
PRJNA894103,Corynebacterium diphtheriae,1717,S,54,17979,18033,0.00209
PRJNA744578,Planktothrix agardhii,1160,S,987,24439,25426,0.00209
PRJNA721101,Massilia oculi,945844,S,2616,172,2788,0.00209
PRJNA819236,Helicobacter typhlonius,76936,S,7893,716,8609,0.00208
PRJNA807746,Weissella jogaejeotgali,1631871,S,73,9406,9479,0.00207
PRJNA1077663,Sphingomonas sp. NBWT7,2596913,S,24,10816,10840,0.00206
PRJNA879945,Pseudomonas fragi,296,S,19,272,291,0.00205
PRJNA398289,Priestia flexa,86664,S,1638545,49656,1688201,0.00204
PRJNA879945,Sneathia vaginalis,187101,S,2454,10,2464,0.00204
PRJDB10133,Rhodopseudomonas boonkerdii,475937,S,1992,390,2382,0.00203
PRJNA807746,Corynebacterium sp. ATCC 6931,1487956,S,39,10697,10736,0.00203
PRJNA879945,Sphingomonas changnyeongensis,2698679,S,25,257,282,0.00203
PRJNA910807,Corynebacterium massiliense,441501,S,20,379,399,0.00203
PRJNA879945,Staphylococcus pasteuri,45972,S,106,62,168,0.00203
PRJNA749068,Delftia tsuruhatensis,180282,S,363,15420,15783,0.00202
PRJNA720296,Segatella copri,165179,S,10794,128,10922,0.00202
PRJNA564695,Pseudomonas fragi,296,S,1662,238,1900,0.00202
PRJNA879945,Acinetobacter baumannii,470,S,27,260,287,0.00202
PRJNA629667,Paucibacter sp. S2-9,3019553,S,15349,1154,16503,0.00201
PRJNA629667,Alcaligenes faecalis,511,S,43,15893,15936,0.00201
PRJNA807746,Akkermansia muciniphila,239935,S,8000,93,8093,0.00201
PRJNA879945,Phocaeicola vulgatus,821,S,330,143,473,0.002
PRJNA912096,Alistipes senegalensis,1288121,S,20,0,20,0.002
PRJNA629667,Porphyromonas endodontalis,28124,S,15681,27,15708,0.002
PRJNA910807,Paeniclostridium sordellii,1505,S,50,9,59,0.002
PRJNA912096,Weissella jogaejeotgali,1631871,S,903,1619,2522,0.00199
PRJDB10133,Mariniblastus fucicola,980251,S,6650,63,6713,0.00198
PRJNA802336,Eggerthella lenta,84112,S,3498501,125155,3623656,0.00198
PRJNA807746,Rhizobium sp. CC-CFT758,2926709,S,16,9179,9195,0.00198
PRJDB10133,Lawsonella clevelandensis,1528099,S,974,7,981,0.00198
PRJNA912096,Duncaniella sp. B8,2576606,S,96,5,101,0.00197
PRJDB15234,Sphingomonas changnyeongensis,2698679,S,20,5243,5263,0.00197
PRJNA692666,Corynebacterium jeikeium,38289,S,329,1560,1889,0.00197
PRJNA610482,Torque teno virus 11,687350,S,45773,9201,54974,0.00194
PRJNA894103,Bacteroides uniformis,820,S,3896,2443,6339,0.00193
PRJNA629667,Acinetobacter sp. NCu2D-2,1608473,S,14559,463,15022,0.00193
PRJNA610482,Mammaliicoccus lentus,42858,S,221870,18679,240549,0.00193
PRJNA693337,Oscillatoria nigro-viridis,482564,S,180,7894,8074,0.00193
PRJNA910807,Blautia wexlerae,418240,S,327,219,546,0.00193
PRJNA847046,Rhizobium sp. CC-CFT758,2926709,S,3078,7702,10780,0.00192
PRJDB10133,Streptococcus pneumoniae,1313,S,62,1183,1245,0.00192
PRJNA894103,Roseburia intestinalis,166486,S,4215,3189,7404,0.00191
PRJNA894103,Ruminococcus bovis,2564099,S,5816,6,5822,0.00191
PRJNA819236,Barnesiella viscericola,397865,S,7308,425,7733,0.0019
PRJEB21503,Acinetobacter sp. TAC-1,3027470,S,72,109,181,0.0019
PRJNA912096,Paenibacillus sp. Cedars,1980674,S,19,0,19,0.0019
PRJNA721101,Sphingomonas panacisoli,1813879,S,40,3385,3425,0.00189
PRJNA894103,Corynebacterium kroppenstedtii,161879,S,3203,2491,5694,0.00189
PRJNA692666,Moraxella osloensis,34062,S,1163,0,1163,0.00189
PRJNA642342,Rhodoplanes sp. Z2-YC6860,674703,S,1575,361,1936,0.00189
PRJNA564695,Corynebacterium ulcerans,65058,S,71,3337,3408,0.00189
PRJNA744578,Thermocoleostomius sinensis,3065396,S,140,22301,22441,0.00188
PRJNA721101,Corynebacterium afermentans,38286,S,163,3020,3183,0.00187
PRJNA847046,Acinetobacter schindleri,108981,S,4996,787,5783,0.00187
PRJNA721101,Sphingomonas morindae,1541170,S,32,2917,2949,0.00187
PRJNA629667,Brucella sp. MAB-22,2986424,S,98,13469,13567,0.00186
PRJNA610482,Salmonella enterica,28901,S,5879,15602,21481,0.00186
PRJNA894103,Roseburia hominis,301301,S,1567,4154,5721,0.00186
PRJNA847046,Dialister succinatiphilus,487173,S,6572,751,7323,0.00186
PRJNA807746,Limosilactobacillus reuteri,1598,S,89,3354,3443,0.00186
PRJNA721101,Deinococcus geothermalis,68909,S,1860,5,1865,0.00185
PRJNA912096,Dorea longicatena,88431,S,38,1,39,0.00184
PRJNA689968,Bifidobacterium adolescentis,1680,S,4797,324,5121,0.00184
PRJNA802336,Moraxella osloensis,34062,S,2241,85,2326,0.00183
PRJNA720296,Arthrospira platensis,118562,S,96,9677,9773,0.00183
PRJNA398289,Chryseobacterium shandongense,1493872,S,427005,27111,454116,0.00183
PRJNA610482,Alphatorquevirus homin9,3048433,S,22676,0,22676,0.00182
PRJNA912212,Roseicitreum antarcticum,564137,S,4506,2957,7463,0.00182
PRJDB10133,Staphylococcus pasteuri,45972,S,2855,56,2911,0.00182
PRJNA879945,Herbinix luporum,1679721,S,3226,181,3407,0.00182
PRJNA1048377,Kocuria sp. TGY1127_2,2711328,S,42,1585,1627,0.00182
PRJDB10133,Sphingobium sp. SYK-6,627192,S,251,11062,11313,0.00181
PRJNA894103,Corynebacterium sp. SCR221107,3017361,S,491,4884,5375,0.00181
PRJNA721101,Veillonella rogosae,423477,S,2739,567,3306,0.00181
PRJNA912096,Streptococcus dysgalactiae,1334,S,101,4396,4497,0.00181
PRJNA912212,Acinetobacter sp. AOR07_HL,2919376,S,50,5934,5984,0.0018
PRJNA629667,Achromobacter insolitus,217204,S,159,14456,14615,0.0018
PRJNA749068,Candidatus Methylopumilus turicensis,1581680,S,21332,2728,24060,0.0018
PRJEB21503,Comamonas odontotermitis,379895,S,16,22,38,0.00179
PRJNA879945,Gemella sanguinis,84135,S,116,31,147,0.00179
PRJNA912212,Moraxella osloensis,34062,S,1515,6,1521,0.00179
PRJNA1077663,Brevundimonas sp. Bb-A,2560058,S,7693,240,7933,0.00179
PRJNA819236,Anaerostipes hadrus,649756,S,6129,1131,7260,0.00178
PRJDB10133,Brachybacterium faecium,43669,S,4798,4224,9022,0.00178
PRJNA912096,Sediminibacillus dalangtanensis,2729421,S,44,8,52,0.00177
PRJNA910807,Acinetobacter baumannii,470,S,68,410,478,0.00177
PRJNA807746,Klebsiella pneumoniae,573,S,770,4852,5622,0.00177
PRJNA912212,Simonsiella muelleri,72,S,1217,104,1321,0.00177
PRJNA879945,Pseudomonas wenzhouensis,2906062,S,26,2111,2137,0.00177
PRJNA879945,Anaerobutyricum hallii,39488,S,2039,449,2488,0.00177
PRJNA695410,Heyndrickxia coagulans,1398,S,548,4116,4664,0.00176
PRJNA802336,Rothia aeria,172042,S,79252,2555,81807,0.00176
PRJDB15234,Bifidobacterium animalis,28025,S,22,434,456,0.00176
PRJNA1077663,Brevundimonas nasdae,172043,S,167,4907,5074,0.00176
PRJNA910807,Corynebacterium diphtheriae,1717,S,22,4643,4665,0.00175
PRJNA910807,Lactobacillus iners,147802,S,47,2,49,0.00175
PRJNA398289,Pteropus lylei-associated alphaherpesvirus,2597167,S,423436,0,423436,0.00174
PRJNA802336,Actinomyces sp. oral taxon 171,706438,S,454220,62563,516783,0.00174
PRJNA429692,Chryseobacterium shandongense,1493872,S,427005,27111,454116,0.00174
PRJNA610482,Moraxella osloensis,34062,S,14261,28,14289,0.00174
PRJNA847046,Brevundimonas naejangsanensis,588932,S,245,6200,6445,0.00174
PRJNA693337,Arthrospira platensis,118562,S,344,6935,7279,0.00174
PRJDB10133,Variovorax paradoxus,34073,S,2895,252,3147,0.00173
PRJNA910807,Rothia mucilaginosa,43675,S,659,9,668,0.00173
PRJNA721101,Corynebacterium bovis,36808,S,83,1074,1157,0.00172
PRJDB15234,Bacteroides caecimuris,1796613,S,340,26,366,0.00172
PRJDB15234,Psychromicrobium lacuslunae,1618207,S,407,2,409,0.00172
PRJNA1077663,Sphingomonas sp. S6-11,2991075,S,63,8927,8990,0.00171
PRJNA912212,Arthrospira platensis,118562,S,129,2057,2186,0.00171
PRJNA1077663,Segatella copri,165179,S,7793,75,7868,0.0017
PRJNA744578,Lysinibacillus sphaericus,1421,S,92,21161,21253,0.00169
PRJNA910807,Bacteroides fragilis,817,S,64,6,70,0.00169
PRJNA847046,Candidatus Saccharimonas aalborgensis,1332188,S,5338,53,5391,0.00169
PRJNA818470,Bartonella krasnovii,2267275,S,84104,38,84142,0.00169
PRJNA1077663,Candidatus Kaistella beijingensis,2820270,S,4776,89,4865,0.00169
PRJNA807746,Komagataeibacter saccharivorans,265959,S,5473,7,5480,0.00168
PRJNA1044261,Sphingomonas nostoxanthinifaciens,2872652,S,1238,9653,10891,0.00168
PRJNA802336,Paenibacillus xylanilyticus,248903,S,848,417,1265,0.00168
PRJNA912212,Brevundimonas sp. Bb-A,2560058,S,690,3525,4215,0.00168
PRJDB10133,Poriferisphaera corsica,2528020,S,5648,3,5651,0.00167
PRJNA629667,Corynebacterium heidelbergense,2055947,S,13599,120,13719,0.00166
PRJNA744578,Simonsiella muelleri,72,S,19928,103,20031,0.00166
PRJNA429692,Pteropus lylei-associated alphaherpesvirus,2597167,S,423436,0,423436,0.00165
PRJDB10133,Magnetospirillum gryphiswaldense,55518,S,5906,267,6173,0.00165
PRJNA879945,Subdoligranulum variabile,214851,S,4180,292,4472,0.00165
PRJNA749068,Candidatus Chromulinivorax destructor,2066483,S,17670,0,17670,0.00164
PRJNA629667,Parvimonas micra,33033,S,13006,27,13033,0.00164
PRJNA564695,Thermus scotoductus,37636,S,1082,57,1139,0.00163
PRJDB10133,Rhizobium oryzihabitans,2267833,S,35,4623,4658,0.00163
PRJNA695410,Enterococcus faecium,1352,S,676,3542,4218,0.00162
PRJNA910807,Odoribacter splanchnicus,28118,S,317,1,318,0.00162
PRJNA629667,Brevundimonas naejangsanensis,588932,S,71,13743,13814,0.00162
PRJNA1077663,Listeria monocytogenes,1639,S,224,14306,14530,0.00161
PRJNA1048173,Pseudomonas sp. BYT-5,2944392,S,154,61685,61839,0.00161
PRJDB10133,Rothia amarae,169480,S,2249,299,2548,0.0016
PRJNA744578,Luteitalea sp. TBR-22,2802971,S,1092,16820,17912,0.0016
PRJNA912096,Jeotgalicoccus sp. WY2,2708346,S,34,0,34,0.0016
PRJNA912096,Staphylococcus gallinarum,1293,S,1957,71,2028,0.0016
PRJNA879945,Corynebacterium sanguinis,2594913,S,21,2346,2367,0.00159
PRJNA910807,Gardnerella swidsinskii,2792979,S,835,32,867,0.00159
PRJNA693337,Haemophilus parainfluenzae,729,S,5751,2460,8211,0.00159
PRJNA695410,Helicobacter typhlonius,76936,S,5390,178,5568,0.00159
PRJNA879945,Lactobacillus intestinalis,151781,S,114,567,681,0.00158
PRJNA1044261,Corynebacterium sp. ATCC 6931,1487956,S,17,6564,6581,0.00158
PRJNA847046,Stenotrophomonas indicatrix,2045451,S,778,4,782,0.00158
PRJEB21503,Pseudomonas putida,303,S,23,135,158,0.00158
PRJNA749068,Rubrobacter xylanophilus,49319,S,20969,56,21025,0.00157
PRJDB10133,Herbaspirillum rubrisubalbicans,80842,S,7823,232,8055,0.00157
PRJNA749068,Gloeocapsa sp. PCC 7428,1173026,S,81,12488,12569,0.00157
PRJNA807746,Corynebacterium jeddahense,1414719,S,475,3470,3945,0.00157
PRJNA749068,Acinetobacter johnsonii,40214,S,20509,447,20956,0.00156
PRJNA879945,Lysobacter antibioticus,84531,S,49,1,50,0.00156
PRJNA879945,Porphyromonas somerae,322095,S,283,1,284,0.00156
PRJNA629667,Sphingomonas taxi,1549858,S,100,13222,13322,0.00155
PRJNA721101,Phocaeicola salanitronis,376805,S,3799,10,3809,0.00155
PRJNA807746,Acetobacter persici,1076596,S,3294,2836,6130,0.00155
PRJNA689968,Rhodoplanes sp. Z2-YC6860,674703,S,1575,361,1936,0.00155
PRJNA398289,Evevirus ev239,2955874,S,80798,27042,107840,0.00155
PRJNA1048377,Salmonella enterica,28901,S,51,11923,11974,0.00154
PRJNA629667,Kocuria palustris,71999,S,6111,8962,15073,0.00154
PRJNA749068,Comamonas aquatica,225991,S,15781,3080,18861,0.00154
PRJNA1048377,Staphylococcus auricularis,29379,S,3855,4,3859,0.00154
PRJNA744578,Akkermansia muciniphila,239935,S,18432,1067,19499,0.00154
PRJNA744578,Oscillatoria nigro-viridis,482564,S,251,17883,18134,0.00153
PRJNA429692,Priestia flexa,86664,S,1469034,44567,1513601,0.00153
PRJNA629667,Achromobacter xylosoxidans,85698,S,237,11134,11371,0.00153
PRJNA744578,Microcystis sp. MC19,1967666,S,65,18051,18116,0.00153
PRJNA721101,Brochothrix thermosphacta,2756,S,1636,3,1639,0.00153
PRJNA692666,Stenotrophomonas rhizophila,216778,S,57,1404,1461,0.00153
PRJNA879945,Haematospirillum jordaniae,1549855,S,217,0,217,0.00153
PRJNA847046,Enterococcus faecalis,1351,S,1331,23,1354,0.00152
PRJNA1048377,Rickettsia amblyommatis,33989,S,285,0,285,0.00152
PRJNA749068,Halomonas sp. CKK8,3036127,S,18,1261,1279,0.00152
PRJNA807746,Weissella confusa,1583,S,58,6359,6417,0.00152
PRJNA879945,Brevundimonas sp. Bb-A,2560058,S,3820,262,4082,0.00152
PRJNA721101,Staphylococcus simulans,1286,S,2441,183,2624,0.00152
PRJNA912096,Ligilactobacillus ruminis,1623,S,29,3,32,0.00151
PRJNA894103,Blautia obeum,40520,S,4639,378,5017,0.00151
PRJNA693337,Streptococcus thermophilus,1308,S,108,3245,3353,0.00151
PRJNA744578,Roseburia hominis,301301,S,15458,4427,19885,0.00151
PRJNA564695,Staphylococcus capitis,29388,S,1512,18,1530,0.00151
PRJNA912212,Peptoniphilus sp. SAHP1,2948573,S,1055,158,1213,0.00151
PRJNA912096,Haemophilus parainfluenzae,729,S,1892,31,1923,0.00151
PRJNA807746,Anaerostipes hadrus,649756,S,6900,718,7618,0.0015
PRJNA720296,Planktothrix agardhii,1160,S,525,7739,8264,0.0015
PRJNA879945,Lawsonella clevelandensis,1528099,S,48,0,48,0.0015
PRJNA807746,Corynebacterium glaucum,187491,S,2026,1943,3969,0.00149
PRJDB15234,Corynebacterium phocae,161895,S,944,1287,2231,0.00149
PRJNA749068,Mesorhizobium terrae,2725666,S,369,21,390,0.00149
PRJNA879945,Parabacteroides distasonis,823,S,30,2039,2069,0.00147
PRJNA912096,Clostridium innocuum,1522,S,26,1,27,0.00147
PRJNA749068,Pseudomonas aeruginosa,287,S,159,2471,2630,0.00147
PRJNA912096,Megamonas funiformis,437897,S,27,0,27,0.00147
PRJNA693337,Friunavirus AbKT21III,2733316,S,4310,791,5101,0.00147
PRJNA721101,Rothia mucilaginosa,43675,S,2557,102,2659,0.00146
PRJEB21503,Malassezia restricta,76775,S,16,0,16,0.00146
PRJNA894103,Phocaeicola dorei,357276,S,3793,252,4045,0.00145
PRJNA879945,Ruminococcus lactaris,46228,S,3684,263,3947,0.00145
PRJNA1048377,Corynebacterium ulcerans,65058,S,43,1352,1395,0.00145
PRJNA564695,Solibaculum mannosilyticum,2780922,S,1386,20,1406,0.00145
PRJNA807746,Fusobacterium mortiferum,850,S,1084,450,1534,0.00144
PRJNA879945,Wolbachia endosymbiont of Drosophila pseudotakahashii,375919,S,189,10,199,0.00144
PRJNA610482,Torque teno virus 8,687347,S,2471,175,2646,0.00143
PRJNA749068,Muricauda aurantiaca,1383885,S,17790,313,18103,0.00143
PRJNA749068,Deinococcus deserti,310783,S,10448,13,10461,0.00143
PRJNA807746,Heyndrickxia coagulans,1398,S,399,3051,3450,0.00143
PRJNA894103,Subdoligranulum variabile,214851,S,3302,10,3312,0.00143
PRJNA912212,Sulfitobacter faviae,1775881,S,292,5534,5826,0.00142
PRJNA807746,Enterococcus faecium,1352,S,98,4612,4710,0.00142
PRJNA629667,Sphingomonas sp. S2-65,2903960,S,227,12465,12692,0.00142
PRJNA749068,Candidatus Kaistella beijingensis,2820270,S,209,2,211,0.00142
PRJDB10133,Gordonia terrae,2055,S,21,4039,4060,0.00142
PRJNA564695,Anaerococcus prevotii,33034,S,1135,98,1233,0.00142
PRJNA564695,Acinetobacter schindleri,108981,S,1298,162,1460,0.00142
PRJDB10133,Enhydrobacter sp.,1894999,S,1995,18,2013,0.00141
PRJNA818470,Jouyvirus ev207,2844249,S,28789,7899,36688,0.00141
PRJNA1048377,Staphylococcus pasteuri,45972,S,2288,123,2411,0.00141
PRJNA629667,Brevundimonas nasdae,172043,S,92,12265,12357,0.00141
PRJNA721101,Blautia wexlerae,418240,S,3087,380,3467,0.00141
PRJNA695410,Bacillus thuringiensis,1428,S,255,2258,2513,0.00141
PRJNA721101,Dolosigranulum pigrum,29394,S,1321,39,1360,0.00141
PRJNA564695,Sphingomonas sp. NBWT7,2596913,S,514,1742,2256,0.0014
PRJNA610482,Ralstonia pickettii,329,S,20418,1185,21603,0.0014
PRJNA807746,Limosilactobacillus mucosae,97478,S,2325,2619,4944,0.0014
PRJNA692666,Achromobacter spanius,217203,S,54,4134,4188,0.00139
PRJNA692666,Corynebacterium pseudogenitalium,38303,S,48,1247,1295,0.00139
PRJNA1048377,Corynebacterium sp. ATCC 6931,1487956,S,31,7932,7963,0.00138
PRJNA693337,Candidatus Atelocyanobacterium thalassa,713887,S,87,5688,5775,0.00138
PRJNA721101,Acinetobacter sp. WCHA45,2004644,S,1611,411,2022,0.00137
PRJNA721101,Kinneretia sp. DAIF2,2714952,S,2141,26,2167,0.00137
PRJDB10133,Salmonella enterica,28901,S,1091,2478,3569,0.00137
PRJNA693337,Streptococcus agalactiae,1311,S,94,8072,8166,0.00137
PRJDB10133,Sphingobium sp. TKS,1315974,S,54,8454,8508,0.00136
PRJNA807746,Lactobacillus helveticus,1587,S,1581,3447,5028,0.00136
PRJNA912212,Veillonella rogosae,423477,S,2113,403,2516,0.00135
PRJNA879945,Parabacteroides merdae,46503,S,340,1288,1628,0.00135
PRJNA807746,Gardnerella vaginalis,2702,S,4915,91,5006,0.00135
PRJNA879945,Staphylococcus capitis,29388,S,117,69,186,0.00134
PRJNA912212,Paracoccus sp. MC1862,2760307,S,48,2392,2440,0.00134
PRJNA629667,Acinetobacter sp. NEB 394,2743575,S,43,11319,11362,0.00133
PRJNA807746,Bifidobacterium longum,216816,S,127,702,829,0.00133
PRJNA693337,Corynebacterium ulcerans,65058,S,84,2499,2583,0.00133
PRJNA879945,Chryseobacterium sp. 6424,2039166,S,2229,1118,3347,0.00133
PRJNA910807,Bifidobacterium adolescentis,1680,S,392,14,406,0.00133
PRJNA879945,Butyrivibrio fibrisolvens,831,S,3494,111,3605,0.00133
PRJEB55147,Corynebacterium macginleyi,38290,S,155481,1259,156740,0.00132
PRJNA912212,Corynebacterium accolens,38284,S,17,2734,2751,0.00132
PRJNA744578,Massilia sp. Se16.2.3,2709303,S,991,14594,15585,0.00131
PRJNA693337,Geovibrio thiophilus,139438,S,5854,5,5859,0.00131
PRJNA894103,Acidaminococcus intestini,187327,S,4913,35,4948,0.00131
PRJDB10133,Sphingomonas hengshuiensis,1609977,S,209,1165,1374,0.00131
PRJNA912212,Asaia bogorensis,91915,S,165,0,165,0.00131
PRJNA1077663,Methylobacterium durans,2202825,S,145,5456,5601,0.00131
PRJNA721101,Anaerococcus sp. Marseille-Q7828,3036300,S,2121,187,2308,0.00131
PRJDB15234,Pseudomonas sp. CFSAN084952,2664899,S,16,358,374,0.0013
PRJNA610482,Segatella copri,165179,S,5123,44,5167,0.0013
PRJNA910807,Prevotella nigrescens,28133,S,54,0,54,0.0013
PRJNA398289,Acinetobacter sp. TAC-1,3027470,S,414612,307337,721949,0.00129
PRJNA692666,Corynebacterium phocae,161895,S,321,1351,1672,0.00129
PRJNA1048173,Streptococcus agalactiae,1311,S,478,45541,46019,0.00129
PRJNA629667,Corynebacterium kroppenstedtii,161879,S,10866,213,11079,0.00129
PRJNA610482,Alphatorquevirus homin6,3048431,S,2345,42,2387,0.00129
PRJNA749068,Methylobacterium organophilum,410,S,23,9360,9383,0.00129
PRJNA720296,Bacillus velezensis,492670,S,5619,1707,7326,0.00128
PRJDB10133,Stenotrophomonas sp. NY11291,2939415,S,29,2111,2140,0.00128
PRJNA749068,Microcystis aeruginosa,1126,S,24,15739,15763,0.00128
PRJNA910807,Streptococcus agalactiae,1311,S,18,1257,1275,0.00127
PRJEB21503,Sphingomonas sp. PAMC26645,2565555,S,105,22,127,0.00127
PRJDB15234,Pseudomonas sp. HN2,2884805,S,35,168,203,0.00127
PRJDB10133,Chryseobacterium shandongense,1493872,S,2777,380,3157,0.00127
PRJEB55147,Flaviflexus ciconiae,2496867,S,6855,87,6942,0.00127
PRJNA720296,Gloeocapsa sp. PCC 7428,1173026,S,16,6777,6793,0.00127
PRJNA894103,Dorea formicigenerans,39486,S,5035,65,5100,0.00126
PRJNA744578,Trichothermofontia sichuanensis,3045816,S,29,15181,15210,0.00125
PRJNA564695,Sphingomonas naphthae,1813468,S,19,1569,1588,0.00125
PRJNA721101,Duncaniella sp. B8,2576606,S,978,31,1009,0.00125
PRJNA610482,Alphatorquevirus homin20,3048422,S,22964,12335,35299,0.00125
PRJDB10133,Mycobacteroides chelonae,1774,S,65,2747,2812,0.00124
PRJNA610482,Alphatorquevirus homin15,3048417,S,2304,0,2304,0.00124
PRJDB10133,Sphingomonas profundi,2681549,S,213,1462,1675,0.00124
PRJNA749068,Sphingomonas profundi,2681549,S,15283,71,15354,0.00124
PRJNA819236,Lactobacillus acetotolerans,1600,S,3327,161,3488,0.00123
PRJNA610482,Staphylococcus caprae,29380,S,137210,5911,143121,0.00123
PRJNA1077663,Marvinbryantia formatexigens,168384,S,6386,83,6469,0.00123
PRJNA429692,Acinetobacter sp. TAC-1,3027470,S,414612,307337,721949,0.00123
PRJNA721101,Corynebacterium matruchotii,43768,S,500,365,865,0.00123
PRJNA629667,Pedobacter sp.,1411316,S,5406,4303,9709,0.00123
PRJNA894103,Prevotella herbatica,2801997,S,3928,153,4081,0.00123
PRJNA749068,Caulobacter mirabilis,69666,S,94,16333,16427,0.00122
PRJNA629667,Geobacillus stearothermophilus,1422,S,3466,6042,9508,0.00122
PRJNA749068,Bacillus sp. ZHX3,2841656,S,60,9774,9834,0.00121
PRJNA692666,Luteimonas sp. YGD11-2,2508168,S,844,158,1002,0.00121
PRJNA912212,Peptostreptococcus sp. CBA3647,3003601,S,1565,3,1568,0.00121
PRJDB10133,Streptococcus agalactiae,1311,S,48,912,960,0.00121
PRJDB10133,Rothia kristinae,37923,S,466,485,951,0.0012
PRJNA629667,Anaerococcus sp. Marseille-Q7828,3036300,S,7151,3820,10971,0.0012
PRJNA818470,Aspergillus ochraceoroseus,138278,S,9418,621,10039,0.0012
PRJNA1048377,Staphylococcus xylosus,1288,S,5503,141,5644,0.00119
PRJNA894103,Pseudomonas marginalis,298,S,3946,2,3948,0.00119
PRJDB10133,Serratia sp. CMO1,2785630,S,53,3349,3402,0.00119
PRJNA398289,Rhodococcus fascians,1828,S,246182,2974,249156,0.00119
PRJDB10133,Agrobacterium tumefaciens,358,S,214,5797,6011,0.00119
PRJNA629667,Sphingomonas panacisoli,1813879,S,191,9971,10162,0.00118
PRJNA894103,Alistipes senegalensis,1288121,S,3241,27,3268,0.00118
PRJDB10133,Elizabethkingia ursingii,1756150,S,22,5984,6006,0.00117
PRJDB15234,Parabacteroides distasonis,823,S,284,19,303,0.00117
PRJNA629667,Haematobacter massiliensis,195105,S,8347,1877,10224,0.00117
PRJNA744578,Candidatus Atelocyanobacterium thalassa,713887,S,49,14152,14201,0.00116
PRJNA564695,Corynebacterium jeikeium,38289,S,336,952,1288,0.00116
PRJNA1048173,Corynebacterium kutscheri,35755,S,42259,999,43258,0.00116
PRJDB10133,Mycolicibacterium holsaticum,152142,S,2021,614,2635,0.00116
PRJNA1048377,Achromobacter sp. AONIH1,1758194,S,35,424,459,0.00115
PRJNA720296,Corynebacterium canis,679663,S,5265,154,5419,0.00115
PRJDB15234,Limosilactobacillus pontis,35787,S,138,363,501,0.00115
PRJNA847046,Filifactor alocis,143361,S,7610,1322,8932,0.00115
PRJNA1048377,Corynebacterium accolens,38284,S,26,1824,1850,0.00115
PRJNA693337,Planktothrix agardhii,1160,S,121,4647,4768,0.00114
PRJNA692666,Acinetobacter baumannii,470,S,116,1360,1476,0.00114
PRJNA749068,Dechloromonas sp. TW-R-39-2,2654218,S,38,13502,13540,0.00114
PRJDB15234,Phocaeicola vulgatus,821,S,819,1377,2196,0.00114
PRJNA429692,Rhodococcus fascians,1828,S,246182,2974,249156,0.00113
PRJNA692666,Prevotella corporis,28128,S,624,1,625,0.00113
PRJDB15234,Megasphaera stantonii,2144175,S,401,9,410,0.00113
PRJDB15234,Salmonella enterica,28901,S,30,325,355,0.00113
PRJNA894103,Cutibacterium acnes,1747,S,13430,48,13478,0.00112
PRJNA749068,Planktothrix agardhii,1160,S,127,8955,9082,0.00112
PRJNA807746,Corynebacterium confusum,71254,S,16,1362,1378,0.00112
PRJNA912212,Stenotrophomonas maltophilia,40324,S,42,21,63,0.00112
PRJNA564695,Methylobacterium radiotolerans,31998,S,576,650,1226,0.00111
PRJNA749068,Streptomyces sp. CB00271,2750025,S,8903,126,9029,0.00111
PRJNA693337,Lactobacillus iners,147802,S,2063,61,2124,0.00111
PRJNA894103,Stenotrophomonas acidaminiphila,128780,S,2393,4187,6580,0.00111
PRJNA807746,Limosilactobacillus fermentum,1613,S,1164,1769,2933,0.0011
PRJNA629667,Peptoniphilus sp. SAHP1,2948573,S,6724,2630,9354,0.0011
PRJNA807746,Phocaeicola dorei,357276,S,4404,734,5138,0.00109
PRJNA1048377,Brevundimonas sp. Bb-A,2560058,S,171,32,203,0.00109
PRJNA749068,Ligilactobacillus agilis,1601,S,14107,91,14198,0.00109
PRJNA749068,Massilia sp. Se16.2.3,2709303,S,106,13656,13762,0.00109
PRJNA749068,Proteiniclasticum sp. QWL-01,3036945,S,14762,68,14830,0.00109
PRJDB10133,Enterococcus faecalis,1351,S,1405,2281,3686,0.00109
PRJNA1048377,Achromobacter insolitus,217204,S,23,1113,1136,0.00109
PRJNA1048377,Corynebacterium jeikeium,38289,S,166,274,440,0.00109
PRJNA564695,Acinetobacter sp. AOR07_HL,2919376,S,29,1587,1616,0.00108
PRJNA564695,Thermus thermophilus,274,S,81,1317,1398,0.00108
PRJNA749068,Caldithrix abyssi,187145,S,132,0,132,0.00108
PRJNA720296,Sphingomonas lutea,1045317,S,1203,3992,5195,0.00107
PRJDB10133,Pseudomonas sp. MPDS,2762896,S,320,689,1009,0.00107
PRJNA695410,Salmonella enterica,28901,S,140,2459,2599,0.00107
PRJNA564695,Stenotrophomonas maltophilia,40324,S,16,1158,1174,0.00106
PRJNA564695,Prevotella corporis,28128,S,624,1,625,0.00106
PRJDB15234,Morganella morganii,582,S,1357,15,1372,0.00106
PRJNA749068,Brevundimonas vitisensis,2800818,S,799,90,889,0.00106
PRJNA1048377,Lawsonella clevelandensis,1528099,S,6043,22,6065,0.00105
PRJNA749068,Massilia varians,457921,S,13761,54,13815,0.00105
PRJNA629667,Arthrospira platensis,118562,S,149,8773,8922,0.00105
PRJNA695410,Anaerostipes hadrus,649756,S,3431,273,3704,0.00105
PRJEB55147,Malassezia restricta,76775,S,13161,13,13174,0.00105
PRJDB10133,Acinetobacter sp. LoGeW2-3,1808001,S,357,1509,1866,0.00105
PRJNA695410,Bacteroides uniformis,820,S,1605,1093,2698,0.00105
PRJEB55147,Escherichia coli,562,S,433,3762,4195,0.00105
PRJDB15234,Megamonas funiformis,437897,S,323,0,323,0.00105
PRJNA807746,Chryseobacterium sp. 6424,2039166,S,2714,1137,3851,0.00104
PRJNA912212,Rothia mucilaginosa,43675,S,2103,16,2119,0.00104
PRJNA564695,Luteimonas sp. YGD11-2,2508168,S,856,159,1015,0.00104
PRJNA720296,Sphingomonas rhizophila,2071607,S,1211,4528,5739,0.00103
PRJNA564695,Veillonella parvula,29466,S,1387,39,1426,0.00103
PRJNA912212,Aquabacterium olei,1296669,S,3097,85,3182,0.00103
PRJNA819236,Parabacteroides distasonis,823,S,455,3873,4328,0.00103
PRJNA692666,Ezakiella coagulans,46507,S,566,0,566,0.00103
PRJNA692666,Heyndrickxia coagulans,1398,S,263,2408,2671,0.00103
PRJDB10133,Pseudomonas marginalis,298,S,551,303,854,0.00103
PRJNA749068,Halalkalibacterium halodurans,86665,S,12902,96,12998,0.00102
PRJNA819236,Prevotella dentalis,52227,S,2781,1447,4228,0.00102
PRJNA720296,Chryseolinea soli,2321403,S,5085,124,5209,0.00102
PRJNA695410,Bacteroides ovatus,28116,S,2327,1243,3570,0.00102
PRJNA847046,Lachnoclostridium phytofermentans,66219,S,7722,205,7927,0.00102
PRJNA744578,Bacillus cereus,1396,S,1541,10750,12291,0.00102
PRJNA695410,Pseudoxanthomonas sp. JBR18,2969308,S,2200,163,2363,0.00102
PRJNA912212,Nitrospirillum amazonense,28077,S,3124,12,3136,0.00101
PRJNA1077663,Aquirhabdus parva,2283318,S,2905,16,2921,0.00101
PRJNA695410,Chryseolinea soli,2321403,S,2933,4,2937,0.00101
PRJNA894103,Gordonia pseudamarae,2831662,S,33,5642,5675,0.00101
PRJNA1077663,Methyloversatilis sp. RAC08,1842540,S,5049,80,5129,0.001
PRJNA1077663,Limnohabitans sp. 63ED37-2,1678128,S,2630,2005,4635,0.001
PRJNA912212,Corynebacterium kutscheri,35755,S,738,953,1691,0.001
PRJNA894103,Gordonia polyisoprenivorans,84595,S,24,5869,5893,0.001
PRJNA720296,Corynebacterium accolens,38284,S,20,4661,4681,0.00099
PRJNA744578,Calothrix sp. NIES-4071,2005469,S,111,11256,11367,0.00099
PRJNA847046,Streptococcus sanguinis,1305,S,2339,23,2362,0.00099
PRJNA629667,Campylobacter ureolyticus,827,S,8606,16,8622,0.00099
PRJNA912212,Erythrobacter sp. SCSIO 43205,2779361,S,861,35,896,0.00099
PRJNA847046,Paracoccus albus,3017784,S,723,3959,4682,0.00098
PRJNA807746,Brucella intermedia,94625,S,221,4312,4533,0.00098
PRJNA629667,Acinetobacter sp. WCHA45,2004644,S,7177,511,7688,0.00098
PRJDB10133,Urbifossiella limnaea,2528023,S,1381,10,1391,0.00098
PRJDB15234,Bacillus subtilis,1423,S,464,801,1265,0.00098
PRJDB15234,Chryseobacterium sp. LJ668,2864040,S,277,4,281,0.00097
PRJNA692666,Hoylesella buccalis,28127,S,2075,1,2076,0.00097
PRJDB15234,Corynebacterium yudongzhengii,2080740,S,1934,67,2001,0.00097
PRJNA564695,Ezakiella coagulans,46507,S,566,1,567,0.00096
PRJNA692666,Pseudoxanthomonas sp. JBR18,2969308,S,2200,163,2363,0.00096
PRJNA693337,Pseudomonas aeruginosa,287,S,21,1830,1851,0.00096
PRJNA564695,Corynebacterium pseudogenitalium,38303,S,50,985,1035,0.00096
PRJNA894103,Enterococcus faecalis,1351,S,32,3055,3087,0.00096
PRJNA629667,Methylobacterium sp. FF17,2984843,S,6543,1789,8332,0.00095
PRJNA744578,Ligilactobacillus faecis,762833,S,8410,3427,11837,0.00095
PRJDB10133,Sphingomonas xanthus,2594473,S,36,952,988,0.00095
PRJDB10133,Cytophaga hutchinsonii,985,S,1079,278,1357,0.00095
PRJNA692666,Staphylococcus capitis,29388,S,822,86,908,0.00095
PRJNA912212,Streptococcus sanguinis,1305,S,3308,135,3443,0.00095
PRJNA693337,Neisseria lactamica,486,S,42,3726,3768,0.00094
PRJNA720296,Methylobacter sp. YRD-M1,2911520,S,4209,357,4566,0.00094
PRJNA564695,Limosilactobacillus fermentum,1613,S,29,2055,2084,0.00093
PRJNA692666,Pseudomonas sp. MTM4,2705472,S,16,655,671,0.00093
PRJNA894103,Corynebacterium kutscheri,35755,S,149,1598,1747,0.00093
PRJNA818470,Aspergillus aculeatus,5053,S,63225,27,63252,0.00092
PRJNA749068,Corynebacterium heidelbergense,2055947,S,6877,90,6967,0.00092
PRJEB21503,Novosphingobium sp. P6W,1609758,S,81,11,92,0.00092
PRJNA894103,Brucella intermedia,94625,S,5169,269,5438,0.00092
PRJNA744578,Corynebacterium yudongzhengii,2080740,S,8945,1466,10411,0.00092
PRJNA692666,Rubrobacter xylanophilus,49319,S,562,0,562,0.00092
PRJNA894103,Coprococcus comes,410072,S,2277,103,2380,0.00091
PRJDB10133,Pedobacter cryoconitis,188932,S,316,1300,1616,0.00091
PRJNA720296,Muribaculum intestinale,1796646,S,4631,157,4788,0.00091
PRJNA912212,Rothia dentocariosa,2047,S,1805,46,1851,0.00091
PRJNA744578,Roseburia intestinalis,166486,S,2074,9937,12011,0.00091
PRJDB15234,Ligilactobacillus sp. BD7642,3050131,S,86,1728,1814,0.00091
PRJNA629667,Myroides phaeus,702745,S,5965,339,6304,0.00091
PRJDB10133,Corynebacterium sanguinis,2594913,S,135,1382,1517,0.00091
PRJNA692666,Allomeiothermus silvanus,52022,S,1049,1,1050,0.00091
PRJDB15234,Streptococcus thermophilus,1308,S,30,248,278,0.0009
PRJDB15234,Ligilactobacillus murinus,1622,S,62,947,1009,0.0009
PRJNA692666,Capnocytophaga sputigena,1019,S,2150,100,2250,0.0009
PRJDB10133,Achromobacter deleyi,1353891,S,56,2375,2431,0.0009
PRJNA564695,Lautropia mirabilis,47671,S,2008,12,2020,0.0009
PRJNA1077663,Limosilactobacillus reuteri,1598,S,7676,497,8173,0.0009
PRJNA749068,Serratia sp. CMO1,2785630,S,23,11394,11417,0.0009
PRJEB21503,Pseudomonas syringae,317,S,21,69,90,0.0009
PRJNA720296,Prochlorococcus marinus,1219,S,92,4686,4778,0.00089
PRJNA564695,Pseudomonas aeruginosa,287,S,25,699,724,0.00089
PRJNA692666,Staphylococcus epidermidis,1282,S,1306,152,1458,0.00089
PRJNA912212,Streptomyces sp. CB00271,2750025,S,1778,13,1791,0.00089
PRJDB15234,Stenotrophomonas sp. SXG-1,2682487,S,267,523,790,0.00089
PRJNA807746,Duncaniella sp. B8,2576606,S,4724,15,4739,0.00088
PRJNA629667,Sphingomonas sp. S6-11,2991075,S,1200,5636,6836,0.00088
PRJNA564695,Geobacillus stearothermophilus,1422,S,310,828,1138,0.00088
PRJNA744578,Corynebacterium sp. ATCC 6931,1487956,S,49,10174,10223,0.00088
PRJNA398289,Cutibacterium granulosum,33011,S,519761,5345,525106,0.00087
PRJNA692666,Dialister succinatiphilus,487173,S,292,189,481,0.00087
PRJEB21503,Bradyrhizobium septentrionale,1404411,S,22,11,33,0.00087
PRJNA695410,Simonsiella muelleri,72,S,1717,91,1808,0.00087
PRJNA695410,Corynebacterium coyleae,53374,S,1185,155,1340,0.00087
PRJNA695410,Coprobacter secundus,1501392,S,2450,533,2983,0.00087
PRJNA695410,Bacillus sp. ZHX3,2841656,S,34,2096,2130,0.00087
PRJNA564695,Hoylesella buccalis,28127,S,2124,2,2126,0.00087
PRJNA693337,Trichothermofontia sichuanensis,3045816,S,4264,189,4453,0.00086
PRJNA744578,Bacillus thuringiensis,1428,S,1345,9766,11111,0.00086
PRJNA744578,Synechococcus sp. PCC 7502,1173263,S,56,10214,10270,0.00086
PRJNA693337,Corynebacterium massiliense,441501,S,16,2125,2141,0.00085
PRJNA629667,Fusobacterium vincentii,155615,S,169,6622,6791,0.00085
PRJNA1077663,Clostridium perfringens,1502,S,596,4150,4746,0.00085
PRJNA564695,Rubrobacter xylanophilus,49319,S,565,0,565,0.00084
PRJNA1077663,Lactobacillus iners,147802,S,3214,692,3906,0.00084
PRJDB15234,Clostridium argentinense,29341,S,107,1,108,0.00084
PRJNA847046,Rhodobacter sp. CZR27,2033869,S,322,3281,3603,0.00084
PRJNA807746,Corynebacterium riegelii,156976,S,408,1971,2379,0.00083
PRJNA1048173,Corynebacterium uberis,2883169,S,27287,132,27419,0.00083
PRJNA693337,Neisseria meningitidis,487,S,340,3917,4257,0.00083
PRJNA564695,Allomeiothermus silvanus,52022,S,1070,0,1070,0.00083
PRJNA629667,Sphingomonas sinipercae,2714944,S,411,6358,6769,0.00083
PRJNA695410,Marvinbryantia formatexigens,168384,S,2928,14,2942,0.00083
PRJNA894103,Schleiferilactobacillus harbinensis,304207,S,2667,22,2689,0.00083
PRJNA629667,Rothia mucilaginosa,43675,S,7070,68,7138,0.00083
PRJNA807746,Hydrogenophilus thermoluteolus,297,S,4137,17,4154,0.00083
PRJNA912212,Kocuria palustris,71999,S,45,1,46,0.00082
PRJNA429692,Evevirus ev239,2955874,S,1309,29,1338,0.00082
PRJDB15234,Methylobacterium sp. FF17,2984843,S,176,301,477,0.00082
PRJNA429692,Cutibacterium granulosum,33011,S,519761,5345,525106,0.00082
PRJNA564695,Dialister succinatiphilus,487173,S,292,188,480,0.00082
PRJNA1077663,Roseburia intestinalis,166486,S,2738,1672,4410,0.00082
PRJNA692666,Bacillus sp. ZHX3,2841656,S,34,2096,2130,0.00081
PRJNA692666,Neisseria subflava,28449,S,1113,253,1366,0.00081
PRJNA692666,Porphyromonas sp. oral taxon 275,712435,S,1737,0,1737,0.00081
PRJNA744578,Geitlerinema sp. PCC 7407,1173025,S,143,9549,9692,0.00081
PRJNA1077663,Helicobacter apodemus,135569,S,2240,64,2304,0.00081
PRJNA894103,Bacteroides stercoris,46506,S,2084,466,2550,0.00081
PRJDB15234,Subdoligranulum variabile,214851,S,249,4,253,0.00081
PRJNA894103,Chordicoccus furentiruminis,2709410,S,2708,2,2710,0.0008
PRJDB15234,Sphingomonas profundi,2681549,S,20,1014,1034,0.0008
PRJNA564695,Clostridium botulinum,1491,S,44,671,715,0.00079
PRJNA744578,Lactobacillus taiwanensis,508451,S,1774,7566,9340,0.00079
PRJEB21503,Pseudomonas aeruginosa,287,S,22,219,241,0.00079
PRJDB15234,Lawsonibacter asaccharolyticus,2108523,S,279,5,284,0.00079
PRJNA894103,Desulfovibrio desulfuricans,876,S,2023,98,2121,0.00079
PRJNA1077663,Pseudomonas putida,303,S,180,2296,2476,0.00079
PRJNA744578,Planktothrix pseudagardhii,132604,S,127,9523,9650,0.00078
PRJNA807746,Veillonella atypica,39777,S,4321,42,4363,0.00078
PRJNA564695,Fusobacterium necrophorum,859,S,18,1054,1072,0.00078
PRJNA912212,Treponema socranskii,53419,S,44,0,44,0.00078
PRJNA749068,Haemophilus parahaemolyticus,735,S,5466,437,5903,0.00078
PRJNA744578,Segatella copri,165179,S,9004,112,9116,0.00077
PRJNA749068,Advenella alkanexedens,1481665,S,10445,15,10460,0.00077
PRJNA749068,Xylanimonas cellulosilytica,186189,S,3859,1754,5613,0.00077
PRJNA807746,Corynebacterium massiliense,441501,S,16,1652,1668,0.00077
PRJNA912212,Rhodococcus coprophilus,38310,S,963,38,1001,0.00077
PRJNA429692,Pseudomonas sp. FJ2-5-13,2976884,S,1395851,384962,1780813,0.00077
PRJNA807746,Desulfovibrio piger,901,S,4001,66,4067,0.00076
PRJNA807746,Helicobacter typhlonius,76936,S,355,2,357,0.00076
PRJNA807746,Finegoldia magna,1260,S,4647,6,4653,0.00076
PRJEB21503,Acinetobacter sp. NyZ410,2929509,S,58,62,120,0.00075
PRJNA912212,Anaerococcus prevotii,33034,S,228,1,229,0.00075
PRJNA807746,Deinococcus ficus,317577,S,4597,1,4598,0.00075
PRJNA695410,Parabacteroides merdae,46503,S,1797,848,2645,0.00075
PRJEB21503,Haemophilus parainfluenzae,729,S,46,1,47,0.00075
PRJNA692666,Acinetobacter schindleri,108981,S,507,32,539,0.00075
PRJNA695410,Blautia obeum,40520,S,719,1908,2627,0.00075
PRJNA692666,Vitreoscilla massiliensis,1689272,S,1768,113,1881,0.00075
PRJNA629667,Lactococcus garvieae,1363,S,58,5365,5423,0.00075
PRJNA912212,Neisseria meningitidis,487,S,22,1371,1393,0.00075
PRJNA807746,Bacteroides uniformis,820,S,1451,1584,3035,0.00074
PRJNA629667,Lysobacter enzymogenes,69,S,1758,4271,6029,0.00074
PRJNA894103,Neorhizobium petrolearium,515361,S,3713,678,4391,0.00074
PRJNA894103,Streptomyces sp. S1A1-8,2594460,S,20,1993,2013,0.00074
PRJNA629667,Chryseobacterium suipulveris,2929800,S,478,5444,5922,0.00073
PRJNA693337,Roseburia intestinalis,166486,S,1324,924,2248,0.00073
PRJNA693337,Ruminococcus bicirculans (ex Wegman et al. 2014),1160721,S,2367,823,3190,0.00073
PRJNA695410,Helicobacter apodemus,135569,S,2335,114,2449,0.00072
PRJNA695410,Finegoldia magna,1260,S,2259,53,2312,0.00072
PRJNA807746,Keratinibaculum paraultunense,1278232,S,1070,7,1077,0.00072
PRJNA564695,Porphyromonas sp. oral taxon 275,712435,S,1765,0,1765,0.00072
PRJNA695410,Streptococcus pneumoniae,1313,S,92,2431,2523,0.00072
PRJNA749068,Streptococcus sanguinis,1305,S,5423,20,5443,0.00072
PRJNA894103,Streptococcus pneumoniae,1313,S,98,3265,3363,0.00072
PRJNA692666,Lactobacillus iners,147802,S,399,1,400,0.00072
PRJNA564695,Lysobacter sp. TY2-98,2290922,S,1182,205,1387,0.00072
PRJNA744578,Streptococcus sanguinis,1305,S,3858,3017,6875,0.00072
PRJNA692666,Fusobacterium necrophorum,859,S,58,1373,1431,0.00072
PRJNA1048173,Brucella sp. MAB-22,2986424,S,16,15105,15121,0.00072
PRJNA1048173,Staphylococcus aureus,1280,S,2879,25872,28751,0.00072
PRJNA564695,Faecalibaculum rodentium,1702221,S,1584,12,1596,0.00072
PRJNA894103,Pseudothauera hydrothermalis,2184083,S,2273,23,2296,0.00071
PRJNA695410,Streptococcus thermophilus,1308,S,17,1517,1534,0.00071
PRJEB55147,Corynebacterium segmentosum,43990,S,68143,36058,104201,0.00071
PRJNA398289,Kocuria sp. KD4,2719588,S,402796,166457,569253,0.00071
PRJNA695410,Bacillus cereus,1396,S,84,560,644,0.00071
PRJNA692666,Psychrobacter sp. WB2,3043330,S,16,1600,1616,0.0007
PRJNA807746,Propionibacterium acidifaciens,556499,S,4263,134,4397,0.0007
PRJNA564695,Janibacter limosus,53458,S,82,631,713,0.0007
PRJNA629667,Brevundimonas vitisensis,2800818,S,1203,4760,5963,0.0007
PRJNA912212,Chryseobacterium oryzae,2929799,S,204,8,212,0.0007
PRJNA629667,Anoxybacillus flavithermus,33934,S,6049,65,6114,0.00069
PRJNA894103,Lentilactobacillus parabuchneri,152331,S,128,1536,1664,0.00069
PRJNA912212,Bacillus subtilis,1423,S,22,784,806,0.00069
PRJNA894103,Lactiplantibacillus plantarum,1590,S,386,2968,3354,0.00069
PRJNA564695,Muribaculum intestinale,1796646,S,518,16,534,0.00069
PRJNA692666,Clostridium baratii,1561,S,388,247,635,0.00069
PRJNA912212,Planktothrix agardhii,1160,S,28,850,878,0.00069
PRJNA749068,Citricoccus sp. SGAir0253,2567881,S,4635,816,5451,0.00068
PRJNA564695,Neisseria subflava,28449,S,1123,254,1377,0.00068
PRJNA749068,Marinobacter shengliensis,1389223,S,8815,160,8975,0.00068
PRJNA693337,Bacteroides uniformis,820,S,1166,183,1349,0.00068
PRJNA912212,Brevibacterium aurantiacum,273384,S,34,4,38,0.00068
PRJNA744578,Paracoccus jeotgali,2065379,S,60,7134,7194,0.00068
PRJNA564695,Kaistella carnis,1241979,S,71,1433,1504,0.00068
PRJNA629667,Salmonella enterica,28901,S,2263,4282,6545,0.00068
PRJNA692666,Chryseobacterium taklimakanense,536441,S,85,1210,1295,0.00068
PRJNA564695,Lactobacillus iners,147802,S,398,2,400,0.00068
PRJNA692666,Chryseobacterium salivictor,2547600,S,24,861,885,0.00068
PRJNA744578,Acinetobacter sp. NyZ410,2929509,S,3334,4501,7835,0.00067
PRJNA629667,Sphingomonas sp.,28214,S,163,5689,5852,0.00067
PRJNA912212,Ezakiella coagulans,46507,S,2154,23,2177,0.00067
PRJNA693337,Anaerostipes hadrus,649756,S,2043,175,2218,0.00067
PRJNA429692,Kocuria sp. KD4,2719588,S,402796,166457,569253,0.00067
PRJNA894103,Bacteroides faecium,2715212,S,2389,25,2414,0.00067
PRJNA807746,Coprobacter secundus,1501392,S,995,10,1005,0.00067
PRJNA744578,Odoribacter splanchnicus,28118,S,7869,440,8309,0.00067
PRJNA629667,Acinetobacter johnsonii,40214,S,5929,265,6194,0.00067
PRJNA695410,Bacteroides caccae,47678,S,776,961,1737,0.00067
PRJNA744578,Chordicoccus furentiruminis,2709410,S,8367,140,8507,0.00067
PRJNA692666,Leucobacter sp. CX169,2813744,S,651,204,855,0.00066
PRJNA564695,Ligilactobacillus salivarius,1624,S,55,1025,1080,0.00066
PRJNA744578,Streptococcus suis,1307,S,18,8576,8594,0.00066
PRJNA695410,Desulfovibrio piger,901,S,2257,78,2335,0.00066
PRJNA894103,Lawsonibacter asaccharolyticus,2108523,S,1513,1,1514,0.00066
PRJNA894103,Moraxella osloensis,34062,S,1072,2651,3723,0.00066
PRJNA912212,Streptococcus pyogenes,1314,S,21,1096,1117,0.00066
PRJNA894103,Blautia sp. SC05B48,2479767,S,535,705,1240,0.00066
PRJNA692666,Olsenella sp. oral taxon 807,712411,S,598,7,605,0.00066
PRJNA629667,Candidatus Kaistella beijingensis,2820270,S,480,4818,5298,0.00065
PRJNA629667,Muribaculum intestinale,1796646,S,5636,142,5778,0.00065
PRJNA894103,Proteiniborus sp. MB09-C3,3050072,S,2879,745,3624,0.00065
PRJNA564695,Brevibacterium sp. CS2,2575923,S,844,2,846,0.00065
PRJNA692666,Bacillus thuringiensis,1428,S,157,1493,1650,0.00065
PRJNA894103,Corynebacterium coyleae,53374,S,230,1697,1927,0.00065
PRJNA629667,Massilia varians,457921,S,5796,87,5883,0.00065
PRJNA692666,Allobaculum mucilyticum,2834459,S,1187,36,1223,0.00064
PRJNA398289,Schlegelella aquatica,376175,S,196235,5389,201624,0.00064
PRJNA744578,Halomicronema hongdechloris,1209493,S,74,7184,7258,0.00064
PRJNA744578,Pseudomonas aeruginosa,287,S,715,6233,6948,0.00064
PRJNA692666,Anaerococcus prevotii,33034,S,251,100,351,0.00064
PRJNA692666,Moraxella bovis,476,S,61,780,841,0.00063
PRJNA749068,Halomonas hydrothermalis,115561,S,33,7974,8007,0.00063
PRJNA564695,Psychrobacter sp. WB2,3043330,S,17,1618,1635,0.00063
PRJNA398289,Tequatrovirus gee4507,2844199,S,132706,4167,136873,0.00063
PRJNA807746,Bacillus thuringiensis,1428,S,32,1209,1241,0.00063
PRJNA629667,Corynebacterium uberis,2883169,S,5195,457,5652,0.00062
PRJNA894103,Clostridium beijerinckii,1520,S,25,3466,3491,0.00062
PRJNA749068,Bacillus safensis,561879,S,5106,89,5195,0.00061
PRJNA749068,Caminicella sporogenes,166485,S,7607,198,7805,0.00061
PRJNA429692,Schlegelella aquatica,376175,S,196235,5389,201624,0.00061
PRJNA744578,Allocoleopsis franciscana,2886352,S,19,7442,7461,0.00061
PRJNA894103,Bacteroides caccae,47678,S,3748,53,3801,0.00061
PRJNA1048173,Streptococcus pneumoniae,1313,S,348,21105,21453,0.00061
PRJNA807746,Parabacteroides merdae,46503,S,779,19,798,0.00061
PRJNA564695,Fusobacterium animalis,76859,S,16,1359,1375,0.00061
PRJNA807746,Acinetobacter sp. WCHA45,2004644,S,165,2664,2829,0.00061
PRJNA749068,Leucobacter sp. CX169,2813744,S,4423,570,4993,0.0006
PRJNA629667,Klebsiella pneumoniae,573,S,4494,1321,5815,0.0006
PRJNA894103,Anoxybacillus caldiproteolyticus,247480,S,1474,23,1497,0.0006
PRJNA894103,Blautia argi,1912897,S,1605,16,1621,0.0006
PRJNA629667,Pedobacter cryoconitis,188932,S,3923,776,4699,0.0006
PRJNA807746,Candidatus Kaistella beijingensis,2820270,S,2408,8,2416,0.0006
PRJNA894103,Nitrospira moscoviensis,42253,S,3284,42,3326,0.00059
PRJNA398289,Streptococcus oralis,1303,S,949,108,1057,0.00059
PRJEB55147,Corynebacterium simulans,146827,S,616958,25526,642484,0.00059
PRJNA629667,Hankyongella ginsenosidimutans,1763828,S,129,5167,5296,0.00059
PRJNA629667,Empedobacter brevis,247,S,5581,6,5587,0.00059
PRJNA807746,Shinella sp. XGS7,2877941,S,165,1674,1839,0.00059
PRJNA744578,Actinoplanes teichomyceticus,1867,S,543,6791,7334,0.00059
PRJNA564695,Olsenella sp. oral taxon 807,712411,S,613,5,618,0.00059
PRJNA564695,Chryseobacterium salivictor,2547600,S,24,849,873,0.00059
PRJNA429692,Tequatrovirus gee4507,2844199,S,132707,4167,136874,0.00059
PRJNA744578,Enterococcus faecium,1352,S,215,7163,7378,0.00059
PRJNA807746,Shewanella sp. NFH-SH190041,2950245,S,2336,51,2387,0.00058
PRJNA749068,Pseudarthrobacter sp. L1SW,2851598,S,75,7580,7655,0.00058
PRJNA894103,Fusobacterium gastrosuis,1755100,S,2020,88,2108,0.00058
PRJNA894103,Bacteroides helcogenes,290053,S,1206,191,1397,0.00058
PRJNA564695,Clostridium baratii,1561,S,391,215,606,0.00058
PRJNA564695,Leucobacter sp. CX169,2813744,S,654,197,851,0.00057
PRJNA807746,Blautia wexlerae,418240,S,1752,292,2044,0.00057
PRJNA744578,Synechococcus sp. JA-3-3Ab,321327,S,54,6856,6910,0.00057
PRJNA807746,Corynebacterium glucuronolyticum,39791,S,22,683,705,0.00057
PRJNA564695,Acinetobacter baumannii,470,S,54,331,385,0.00057
PRJNA807746,Escherichia coli,562,S,173,2258,2431,0.00057
PRJNA744578,Sinorhizobium meliloti,382,S,42,6865,6907,0.00057
PRJNA564695,Corynebacterium resistens,258224,S,27,503,530,0.00056
PRJNA429692,Streptococcus oralis,1303,S,949,108,1057,0.00056
PRJNA807746,Methylobacterium organophilum,410,S,169,2062,2231,0.00056
PRJNA744578,Pseudomonas sp. S150,2559074,S,20,6020,6040,0.00056
PRJNA749068,Geobacillus thermodenitrificans,33940,S,16,7408,7424,0.00056
PRJNA564695,Allobaculum mucilyticum,2834459,S,1207,44,1251,0.00056
PRJNA807746,Collinsella aerofaciens,74426,S,3009,0,3009,0.00056
PRJNA629667,Porphyromonas somerae,322095,S,4560,0,4560,0.00056
PRJNA629667,Acinetobacter schindleri,108981,S,3906,656,4562,0.00055
PRJNA398289,Pseudomonas oleovorans,301,S,253,438,691,0.00055
PRJNA629667,Prevotella corporis,28128,S,4568,335,4903,0.00055
PRJNA629667,Massilia oculi,945844,S,3342,946,4288,0.00055
PRJNA744578,Massilia oculi,945844,S,4883,1674,6557,0.00054
PRJNA744578,Corynebacterium diphtheriae,1717,S,18,6265,6283,0.00054
PRJNA807746,Sneathia vaginalis,187101,S,481,0,481,0.00054
PRJNA807746,Anaerococcus sp. Marseille-Q7828,3036300,S,1978,50,2028,0.00053
PRJNA744578,Sandaracinus amylolyticus,927083,S,6258,24,6282,0.00053
PRJNA749068,Brachybacterium faecium,43669,S,3847,508,4355,0.00053
PRJNA749068,Miniphocaeibacter halophilus,2931922,S,828,2,830,0.00052
PRJNA749068,Schaalia sp. 19OD2882,2794089,S,6578,116,6694,0.00052
PRJNA429692,Pseudomonas oleovorans,301,S,253,438,691,0.00052
PRJNA749068,Limosilactobacillus fermentum,1613,S,6156,71,6227,0.00051
PRJNA807746,Lachnospira eligens,39485,S,1820,28,1848,0.00051
PRJNA749068,Bacillus sp. CMF21,2884832,S,84,4272,4356,0.00051
PRJNA629667,Corynebacterium matruchotii,43768,S,4060,448,4508,0.00051
PRJNA398289,Streptococcus mutans,1309,S,224711,8181,232892,0.0005
PRJEB55147,Corynebacterium kroppenstedtii,161879,S,141,2,143,0.0005
PRJNA744578,Corynebacterium aquatimens,1190508,S,25,5075,5100,0.00049
PRJNA629667,Deinococcus aquaticus,328692,S,3626,573,4199,0.00049
PRJNA749068,Kocuria sp. TGY1127_2,2711328,S,31,6275,6306,0.00049
PRJNA744578,Faecalibacterium prausnitzii,853,S,1059,4430,5489,0.00049
PRJNA807746,Segatella copri,165179,S,1766,0,1766,0.00049
PRJNA749068,Lawsonella clevelandensis,1528099,S,3782,1,3783,0.00049
PRJNA629667,Marvinbryantia formatexigens,168384,S,4360,0,4360,0.00049
PRJNA629667,Methylorubrum extorquens,408,S,22,4033,4055,0.00048
PRJNA1048173,Geodermatophilus obscurus,1861,S,15288,1028,16316,0.00048
PRJNA429692,Streptococcus mutans,1309,S,224711,8181,232892,0.00048
PRJNA744578,Olivibacter sp. LS-1,2592345,S,5005,99,5104,0.00048
PRJNA744578,Dietzia sp. oral taxon 368,712270,S,34,5429,5463,0.00048
PRJNA749068,Paracoccus aminophilus,34003,S,6050,37,6087,0.00047
PRJNA744578,Cupriavidus pauculus,82633,S,4731,398,5129,0.00047
PRJNA744578,Kurthia zopfii,1650,S,4878,231,5109,0.00046
PRJNA629667,Sphingomonas sp. SUN039,2937787,S,244,3367,3611,0.00045
PRJNA629667,Exiguobacterium alkaliphilum,1428684,S,3098,278,3376,0.00045
PRJNA744578,Clostridium perfringens,1502,S,17,5858,5875,0.00045
PRJNA429692,Sphingobium yanoikuyae,13690,S,867998,185545,1053543,0.00044
PRJNA629667,Moraxella ovis,29433,S,22,3702,3724,0.00044
PRJNA744578,Nostoc edaphicum,264686,S,22,5021,5043,0.00043
PRJNA398289,Streptococcus phage D1024,2108109,S,521,17,538,0.00043
PRJNA629667,Fusobacterium animalis,76859,S,122,3079,3201,0.00043
PRJNA744578,Paenibacillus sp. URB8-2,2741301,S,4666,63,4729,0.00043
PRJNA629667,Paracoccus sp. AK26,2589076,S,3347,294,3641,0.00043
PRJNA744578,Corynebacterium massiliense,441501,S,49,5078,5127,0.00042
PRJNA629667,Bacteroides uniformis,820,S,3427,249,3676,0.00042
PRJNA429692,Streptococcus phage D1024,2108109,S,521,17,538,0.00041
PRJNA629667,Acidovorax sp. 1608163,2478662,S,23,3205,3228,0.00041
PRJNA629667,Exiguobacterium antarcticum,132920,S,25,3353,3378,0.0004
PRJNA629667,Pontibrevibacter nitratireducens,2758038,S,1561,2169,3730,0.0004
PRJNA1048173,Corynebacterium durum,61592,S,14868,8,14876,0.00039
PRJNA1048173,Elizabethkingia miricola,172045,S,112,16949,17061,0.00039
PRJNA744578,Aliiroseovarius sp. M344,2867010,S,4349,406,4755,0.00039
PRJNA629667,Escherichia coli,562,S,2176,1632,3808,0.00039
PRJNA629667,Paracoccus aminophilus,34003,S,1990,1024,3014,0.00038
PRJNA744578,Egicoccus halophilus,1670830,S,3197,5,3202,0.00038
PRJEB55147,Salmonella enterica,28901,S,174,1429,1603,0.00038
PRJNA744578,Algoriphagus sp. Y33,2772483,S,3973,111,4084,0.00038
PRJNA629667,Leptotrichia sp. oral taxon 218,712361,S,2962,33,2995,0.00038
PRJNA744578,Corynebacterium zhongnanshanii,2768834,S,904,3692,4596,0.00037
PRJNA744578,Janthinobacterium sp. 17J80-10,2497863,S,4291,125,4416,0.00037
PRJNA744578,Kovacikia minuta,2931930,S,49,4404,4453,0.00037
PRJNA744578,Cellvibrio sp. PSBB006,1987723,S,3909,416,4325,0.00037
PRJNA744578,Lactococcus taiwanensis,1151742,S,2410,1826,4236,0.00037
PRJNA629667,Paenibacillus sp. DR312,2871175,S,44,2749,2793,0.00037
PRJNA1048173,Cupriavidus metallidurans,119219,S,69,11680,11749,0.00036
PRJNA629667,Methylobacterium organophilum,410,S,266,2267,2533,0.00034
PRJNA744578,Anthocerotibacter panamensis,2857077,S,68,4073,4141,0.00034
PRJNA744578,Corynebacterium heidelbergense,2055947,S,611,3010,3621,0.00033
PRJNA744578,Janibacter limosus,53458,S,723,3358,4081,0.00033
PRJNA629667,Ralstonia sp. RS647,2880989,S,21,2841,2862,0.00033
PRJNA744578,Megasphaera stantonii,2144175,S,2770,1491,4261,0.00033
PRJNA629667,Neisseria subflava,28449,S,804,1701,2505,0.00032
PRJNA744578,Subdoligranulum variabile,214851,S,3329,428,3757,0.00031
PRJNA744578,Streptococcus dysgalactiae,1334,S,200,3900,4100,0.00031
PRJNA744578,Prevotella dentalis,52227,S,79,3974,4053,0.00031
PRJNA744578,Lactobacillus gasseri,1596,S,1377,2369,3746,0.00031
PRJNA744578,Bacillus anthracis,1392,S,1210,2626,3836,0.0003
PRJNA1048173,Dolosigranulum pigrum,29394,S,12310,225,12535,0.0003
PRJNA744578,Labilithrix luteola,1391654,S,3440,12,3452,0.0003
PRJNA629667,Streptococcus thermophilus,1308,S,646,1983,2629,0.00029
PRJNA744578,Finegoldia magna,1260,S,3432,10,3442,0.00029
PRJNA629667,Sinorhizobium meliloti,382,S,39,2154,2193,0.00029
PRJNA629667,Erythrobacter sp. A30-3,2785907,S,21,2732,2753,0.00029
PRJNA1048173,Faecalibacterium prausnitzii,853,S,1246,11457,12703,0.00028
PRJNA1048173,Cupriavidus sp. MP-37,2884455,S,62,10807,10869,0.00028
PRJNA629667,Caulobacter segnis,88688,S,2402,55,2457,0.00027
PRJNA629667,Brevundimonas sp. M20,2591463,S,303,1640,1943,0.00027
PRJNA629667,Brevundimonas sp. Bb-A,2560058,S,227,2145,2372,0.00027
PRJNA629667,Duncaniella sp. B8,2576606,S,2261,70,2331,0.00026
PRJNA629667,Chryseobacterium sp. POL2,2713414,S,162,1320,1482,0.00024
PRJNA629667,Prevotella sp. oral taxon 475,712471,S,1575,248,1823,0.00024
PRJNA629667,Parageobacillus thermoglucosidasius,1426,S,1920,35,1955,0.00024
PRJNA629667,Lawsonella clevelandensis,1528099,S,1924,56,1980,0.00024
PRJNA629667,Sphingomonas sediminicola,386874,S,269,1841,2110,0.00024
PRJNA1048173,Chryseobacterium sp. ZHDP1,2838877,S,8319,1656,9975,0.00024
PRJNA629667,Pannonibacter phragmitetus,121719,S,1032,924,1956,0.00024
PRJNA629667,Janthinobacterium sp. PAMC25594,2861284,S,18,1527,1545,0.00023
PRJNA629667,Veillonella parvula,29466,S,1308,620,1928,0.00023
PRJNA629667,Corynebacterium pseudotuberculosis,1719,S,46,1879,1925,0.00023
PRJNA629667,Variovorax paradoxus,34073,S,1491,26,1517,0.00023
PRJNA629667,Streptococcus urinalis,149016,S,1522,211,1733,0.00022
PRJNA1048173,Anaerococcus prevotii,33034,S,7851,44,7895,0.00022
PRJNA629667,Leptotrichia buccalis,40542,S,1813,116,1929,0.00022
PRJNA629667,Fusobacterium nucleatum,851,S,60,1615,1675,0.00022
PRJNA629667,Flavisolibacter ginsenosidimutans,661481,S,1778,4,1782,0.00022
PRJEB55147,Klebsiella pneumoniae,573,S,47,62,109,0.00022
PRJNA629667,Pseudocnuella soli,2502779,S,951,983,1934,0.00022
PRJEB55147,Chroococcidiopsis thermalis,54299,S,25,52,77,0.00021
PRJNA629667,Corynebacterium durum,61592,S,1691,164,1855,0.00021
PRJNA629667,Hoylesella buccalis,28127,S,1862,4,1866,0.00021
PRJNA629667,Brochothrix thermosphacta,2756,S,1674,1,1675,0.00021
PRJNA1048173,Morganella morganii,582,S,7298,88,7386,0.00021
PRJNA629667,Neisseria meningitidis,487,S,1613,197,1810,0.00021
PRJNA629667,Ferruginibacter lapsinanis,563172,S,1784,233,2017,0.00021
PRJNA1048173,Cupriavidus sp. EM10,2839983,S,29,7335,7364,0.0002
PRJNA1048173,Acinetobacter baumannii,470,S,305,7318,7623,0.0002
PRJNA1048173,Subdoligranulum variabile,214851,S,8720,454,9174,0.0002
PRJNA629667,Veillonella rogosae,423477,S,1386,109,1495,0.0002
PRJNA629667,Acinetobacter pittii,48296,S,1708,118,1826,0.0002
PRJNA629667,Jeotgalicoccus sp. WY2,2708346,S,1766,5,1771,0.0002
PRJNA629667,Staphylococcus sp. IVB6181,2929481,S,1727,11,1738,0.0002
PRJNA629667,Altererythrobacter rubellus,2173831,S,19,1640,1659,0.0002
PRJNA629667,Chryseobacterium sp. PET-29,2983267,S,32,1640,1672,0.0002
PRJNA629667,Dermacoccus nishinomiyaensis,1274,S,1542,243,1785,0.0002
PRJNA629667,Rothia amarae,169480,S,1261,381,1642,0.00019
PRJNA629667,Prevotella intermedia,28131,S,1574,52,1626,0.00019
PRJNA629667,Capnocytophaga gingivalis,1017,S,1478,1,1479,0.00019
PRJNA629667,Sphingobacterium faecium,34087,S,346,1169,1515,0.00019
PRJNA629667,Streptococcus sanguinis,1305,S,1681,19,1700,0.00019
PRJNA629667,Paracoccus jeotgali,2065379,S,18,1571,1589,0.00019
PRJNA629667,Campylobacter avium,522485,S,796,799,1595,0.00019
PRJNA1048173,Deinococcus deserti,310783,S,5869,19,5888,0.00018
PRJNA1048173,Sediminibacterium sp. TEGAF015,575378,S,3516,163,3679,0.00018
PRJNA1048173,Cupriavidus pauculus,82633,S,56,8008,8064,0.00017
PRJNA1048173,Paracoccus stylophorae,659350,S,5652,1306,6958,0.00017
PRJNA1048173,Methylobacterium radiotolerans,31998,S,1792,1634,3426,0.00016
PRJEB55147,Moraxella osloensis,34062,S,886,3,889,0.00014
